"","totphys_3m","totnonphys_3m","totwork_3m","totschool_3m","totother_3m","tothome_3m","totcon_all_3m","AGE_I","GENDER_I","INCOME_I","RACE_ETHNICITY_I","totphys","totnonphys","totwork","totschool","totother","tothome","totcon_all","WTFinal_US_M3_AbIGg"
"1",1,2,0,0,1,2,3,6,1,6,2,1,2,0,0,2,1,3,54109.0590397888
"2",4,0,0,0,0,4,4,2,2,3,3,6,1,0,0,1,6,7,364011.324313956
"3",5,4,0,0,4,5,9,5,1,6,2,3,6,0,0,6,3,9,55807.3233239448
"4",2,2,0,0,4,0,4,5,1,6,2,0,2,0,0,2,0,2,46635.2658818798
"5",0,1,0,0,0,1,1,4,2,6,2,1,0,0,0,0,1,1,38021.9518633931
"6",0,1,0,0,1,0,1,3,2,5,2,1,3,0,0,4,0,4,53672.0608752985
"7",0,6,6,0,0,0,6,6,2,3,2,0,5,5,0,0,0,5,123399.647082596
"8",1,0,0,0,0,1,1,6,1,3,2,1,1,0,0,1,1,2,21122.851442336
"9",1,0,0,0,0,1,1,6,1,6,2,0,1,0,0,0,1,1,18443.6369449211
"10",0,1,1,0,0,0,1,4,1,8,2,0,0,0,0,0,0,0,129991.336772974
"11",0,0,0,0,0,0,0,5,2,1,2,0,0,0,0,0,0,0,77436.8495450611
"12",0,0,0,0,0,0,0,6,1,5,2,0,1,0,0,0,1,1,336105.589868229
"13",2,0,0,0,0,2,2,5,2,3,2,1,0,0,0,0,1,1,142352.919679542
"14",2,0,0,0,0,2,2,3,2,4,4,2,0,0,0,0,2,2,98983.0643562624
"15",1,0,0,0,0,1,1,5,2,1,2,1,0,0,0,0,1,1,133488.254893382
"16",0,10,0,0,10,0,10,5,2,3,2,0,5,0,0,5,0,5,25676.9550340999
"17",0,0,0,0,0,0,0,4,2,6,2,6,41,46,0,0,1,47,37833.7923086166
"18",1,2,1,0,0,2,3,4,2,7,2,2,3,0,0,5,0,5,161534.30649157
"19",8,3,0,0,0,11,11,2,2,2,2,7,10,0,0,10,7,17,81684.7101541324
"20",1,0,0,0,0,1,1,6,1,5,2,1,0,0,0,0,1,1,19012.9443766639
"21",7,0,0,0,0,7,7,2,1,3,2,5,2,2,0,0,5,7,230472.284594723
"22",1,2,0,0,2,1,3,4,1,8,1,0,1,0,0,1,0,1,428450.499839829
"23",1,0,0,0,0,1,1,6,1,6,2,1,0,0,0,0,1,1,195019.714813798
"24",1,2,0,0,2,1,3,5,2,6,2,1,1,0,0,0,2,2,51629.0857659355
"25",2,17,0,0,15,4,19,5,2,3,2,4,1,0,0,1,4,5,142352.919679542
"26",3,0,0,0,0,3,3,3,2,6,2,3,9,0,0,9,3,12,74122.98479219
"27",0,11,0,0,10,1,11,4,2,8,2,4,3,0,0,3,4,7,178761.692056438
"28",3,0,0,0,0,3,3,3,1,6,2,3,2,0,0,2,3,5,301748.391710554
"29",2,0,0,0,1,1,2,4,2,6,2,14,0,0,0,0,14,14,73528.9523347493
"30",3,3,0,0,3,3,6,3,2,6,2,8,7,11,0,0,4,15,49680.3552869555
"31",4,7,6,0,0,5,11,2,1,6,2,10,0,0,0,6,4,10,197253.34049533
"32",2,4,0,0,6,0,6,6,2,3,2,2,1,0,0,0,3,3,299339.885907448
"33",5,4,3,0,2,4,9,5,1,4,2,3,8,8,0,3,0,11,81605.5148103675
"34",5,1,0,0,2,4,6,3,2,1,2,0,1,0,0,0,1,1,20640.9601304884
"35",3,1,0,0,0,4,4,3,2,3,2,2,4,3,0,0,3,6,121565.681727042
"36",14,0,0,0,9,5,14,4,1,6,2,4,11,0,0,7,8,15,40435.1014187876
"37",6,3,0,0,0,9,9,4,1,7,3,3,0,0,0,0,3,3,408032.638002313
"38",1,11,10,0,0,2,12,2,2,4,2,1,5,5,0,0,1,6,58423.9842184866
"39",1,0,0,0,0,1,1,4,2,3,2,1,0,0,0,0,1,1,73631.2684459317
"40",0,2,0,0,2,0,2,4,2,8,2,2,15,15,0,0,2,17,189654.336324428
"41",0,2,0,0,2,0,2,5,2,5,3,0,0,0,0,0,0,0,72948.3130537402
"42",6,0,0,0,0,6,6,4,1,5,2,1,14,11,0,2,2,15,92706.0215294342
"43",1,2,0,0,2,1,3,6,2,2,2,16,10,0,0,26,0,26,42940.1001389558
"44",0,3,0,0,3,0,3,5,2,3,2,0,2,0,0,2,0,2,60954.4895733083
"45",0,0,0,0,0,0,0,6,1,2,2,1,0,0,0,0,1,1,292875.34687574
"46",3,1,0,0,0,4,4,3,2,7,2,2,0,0,0,0,2,2,32197.2202339242
"47",1,5,1,0,4,1,6,4,2,5,2,1,8,2,0,3,4,9,60269.8819983013
"48",1,0,0,0,0,1,1,6,1,6,2,1,0,0,0,0,1,1,51970.0816910407
"49",0,0,0,0,0,0,0,6,2,2,2,1,3,0,0,3,1,4,154001.28997415
"50",4,0,0,0,0,4,4,5,1,5,2,0,5,0,0,1,4,5,25198.480769724
"51",0,0,0,0,0,0,0,6,2,2,2,0,0,0,0,0,0,0,153604.359044416
"52",7,5,6,2,0,4,12,3,2,8,2,4,0,0,0,0,4,4,195313.111155427
"53",5,30,17,0,2,16,35,5,2,3,2,6,20,0,0,26,0,26,13520.5818438087
"54",1,0,0,0,0,1,1,3,1,3,2,1,0,0,0,0,1,1,25848.2931258368
"55",0,0,0,0,0,0,0,4,2,5,2,0,4,0,0,4,0,4,23726.1302067453
"56",1,5,0,0,0,6,6,4,2,8,2,1,1,0,0,1,1,2,253416.855462057
"57",3,0,0,0,2,1,3,1,2,6,2,15,18,0,3,20,10,33,270083.185507543
"58",1,1,0,0,0,2,2,5,2,6,2,1,0,0,0,0,1,1,168189.684486671
"59",0,0,0,0,0,0,0,6,2,3,2,0,0,0,0,0,0,0,3238.25594841509
"60",2,1,0,0,1,2,3,6,1,2,2,2,0,0,0,0,2,2,21940.9268218364
"61",0,1,0,0,0,1,1,5,1,2,2,0,1,0,0,0,1,1,29359.6804289704
"62",2,3,0,0,3,2,5,4,2,7,2,5,25,0,0,0,30,30,68707.9641597939
"63",4,0,0,0,0,4,4,2,1,6,2,9,4,0,0,4,9,13,122836.595643959
"64",0,0,0,0,0,0,0,6,1,7,2,0,0,0,0,0,0,0,142535.433173356
"65",0,6,0,0,5,1,6,5,1,2,2,0,4,0,0,0,4,4,241339.674238353
"66",5,5,0,0,10,0,10,6,2,3,3,0,1,0,0,0,1,1,120562.856340658
"67",5,3,0,0,5,3,8,4,1,8,2,3,37,0,0,34,6,40,112826.948165255
"68",6,8,0,0,11,3,14,2,2,4,2,12,11,0,0,11,12,23,165289.73775646
"69",1,0,0,0,0,1,1,6,1,4,2,1,0,0,0,0,1,1,30735.754614758
"70",7,3,0,0,8,2,10,5,2,7,2,1,1,0,0,1,1,2,48007.1180958454
"71",60,2,0,0,21,41,62,1,2,1,4,3,2,0,0,0,5,5,533968.645704513
"72",2,1,0,0,1,2,3,6,1,5,2,4,2,0,0,1,5,6,9816.54975217356
"73",1,12,7,0,4,2,13,2,2,5,2,0,0,0,0,0,0,0,67034.3614504287
"74",1,0,0,0,0,1,1,5,1,6,2,1,1,0,0,1,1,2,44999.7713802107
"75",1,30,30,0,0,1,31,1,2,4,2,2,10,0,0,12,0,12,134222.981039511
"76",6,5,0,0,6,5,11,3,1,6,2,12,15,24,0,0,3,27,221093.62998104
"77",0,0,0,0,0,0,0,3,1,1,2,0,0,0,0,0,0,0,31860.4155221991
"78",3,0,0,0,0,3,3,4,1,8,2,3,14,14,0,0,3,17,112826.948165255
"79",0,2,0,0,2,0,2,6,2,2,2,1,0,0,0,1,0,1,50763.2692418264
"80",1,8,8,0,0,1,9,6,1,4,2,1,2,0,0,2,1,3,63891.1374599018
"81",2,0,0,0,0,2,2,6,2,2,2,2,5,0,0,5,2,7,243216.745589732
"82",1,0,0,0,0,1,1,6,1,4,2,1,0,0,0,0,1,1,15578.7689094531
"83",1,0,0,0,0,1,1,6,1,8,2,1,0,0,0,0,1,1,94021.6115764588
"84",1,3,0,0,3,1,4,2,2,1,2,0,1,0,0,1,0,1,10641.4965279312
"85",0,1,1,0,0,0,1,5,1,7,2,0,0,0,0,0,0,0,143385.674564015
"86",4,3,0,0,1,6,7,3,1,6,2,9,0,0,0,0,9,9,221093.62998104
"87",1,3,2,0,1,1,4,5,1,3,1,0,3,0,0,2,1,3,156007.156425209
"88",15,4,0,0,14,5,19,3,2,4,2,60,52,65,0,40,7,112,404993.00261103
"89",2,0,0,0,0,2,2,2,2,8,2,2,3,0,2,1,2,5,135803.354113782
"90",3,0,0,0,0,3,3,1,2,5,2,37,15,30,0,19,3,52,83589.6889993269
"91",1,27,27,0,0,1,28,6,2,7,2,1,0,0,0,0,1,1,62417.9238366935
"92",1,3,0,0,4,0,4,5,2,3,2,1,1,0,0,2,0,2,60241.4247119904
"93",6,11,10,0,5,2,17,3,2,2,2,68,43,106,0,0,5,111,360755.681184505
"94",2,6,0,0,8,0,8,6,1,6,2,0,0,0,0,0,0,0,33695.6149348611
"95",5,0,0,0,0,5,5,5,1,6,2,3,0,2,0,0,1,3,110755.860092002
"96",0,202,200,0,1,1,202,5,2,3,3,0,3,0,0,1,2,3,99043.3197364778
"97",3,0,0,0,0,3,3,2,2,1,3,0,0,0,0,0,0,0,60233.6645626692
"98",2,5,5,0,2,0,7,4,2,7,2,0,1,0,0,0,1,1,54936.4464515548
"99",3,1,0,0,1,3,4,4,1,7,2,3,2,1,0,1,3,5,99361.8769773944
"100",0,2,0,0,2,0,2,6,2,3,2,0,0,0,0,0,0,0,41475.6387421452
"101",16,37,30,0,22,1,53,2,2,4,2,10,11,16,0,1,4,21,58737.7733527845
"102",2,5,0,0,5,2,7,2,2,4,2,10,73,79,0,0,4,83,138498.917561951
"103",1,4,4,0,0,1,5,6,1,5,2,7,6,0,0,12,1,13,7451.03864454674
"104",5,0,1,0,3,1,5,5,1,4,2,5,2,2,0,2,3,7,529138.919906015
"105",4,3,0,0,3,4,7,3,2,6,2,7,15,7,6,4,5,22,134948.460882131
"106",3,8,0,0,8,3,11,3,2,4,2,4,4,0,0,4,4,8,78369.1564041681
"107",77,1,0,0,0,78,78,6,2,4,2,1,0,0,0,0,1,1,27309.9012023546
"108",0,0,0,0,0,0,0,5,1,3,2,0,0,0,0,0,0,0,73046.8973439172
"109",3,0,0,0,0,3,3,6,2,6,2,7,6,0,0,6,7,13,406226.890313349
"110",3,2,3,0,0,2,5,2,2,7,2,5,0,0,0,4,1,5,147403.354902034
"111",0,0,0,0,0,0,0,6,2,3,2,0,0,0,0,0,0,0,14088.7261505038
"112",3,0,0,0,0,3,3,3,1,8,2,3,1,0,1,0,3,4,206665.668236195
"113",3,32,31,0,0,4,35,5,2,6,2,0,1,0,0,0,1,1,108981.262453651
"114",0,1,0,0,1,0,1,6,1,2,2,0,0,0,0,0,0,0,11933.7347446845
"115",0,1,0,0,0,1,1,6,2,3,2,0,0,0,0,0,0,0,148307.049207538
"116",1,17,0,0,17,1,18,4,2,5,2,0,1,0,0,0,1,1,24398.6941035416
"117",1,0,0,0,0,1,1,2,2,5,2,4,2,0,0,6,0,6,69787.668071339
"118",4,1,0,1,0,4,5,3,2,8,2,4,2,0,0,2,4,6,15367.3623477598
"119",2,0,0,0,1,1,2,6,1,8,2,0,1,0,0,1,0,1,539957.475859467
"120",2,6,6,0,0,2,8,6,2,3,2,0,3,3,0,0,0,3,24617.7224978222
"121",1,1,1,0,0,1,2,4,2,4,2,1,4,4,0,0,1,5,48032.3205621404
"122",2,4,0,0,3,3,6,6,2,5,2,3,1,0,0,0,4,4,18925.3222398352
"123",0,0,0,0,0,0,0,3,2,3,2,5,4,4,0,0,5,9,20121.453946052
"124",3,20,14,0,2,7,23,6,1,5,2,24,20,2,7,20,15,44,24474.2114625847
"125",2,3,0,0,3,2,5,2,1,5,2,7,20,0,0,26,1,27,92425.0663507484
"126",2,2,0,0,1,3,4,3,2,6,2,1,0,0,0,0,1,1,51380.0902183053
"127",14,3,6,0,10,1,17,3,1,8,2,11,10,8,0,9,4,21,268031.5293261
"128",2,3,0,0,0,5,5,2,1,3,2,3,0,0,0,0,3,3,68325.8697950199
"129",0,1,0,0,0,1,1,5,2,6,2,1,2,0,0,2,1,3,99695.4173751796
"130",1,1,0,0,0,2,2,2,1,2,2,1,4,3,0,0,2,5,60794.3052279053
"131",0,64,60,0,2,2,64,5,2,4,2,0,50,50,0,0,0,50,54429.9975094729
"132",1,1,0,0,0,2,2,5,2,5,2,1,1,0,0,1,1,2,252507.009831835
"133",2,4,0,0,4,2,6,2,1,3,2,2,2,0,0,2,2,4,41214.0545283305
"134",5,2,0,0,2,5,7,6,1,4,2,4,1,0,0,5,0,5,24527.5100271867
"135",1,2,0,0,0,3,3,6,2,2,2,1,0,0,0,0,1,1,53726.9441000382
"136",1,0,0,0,0,1,1,2,2,2,2,1,0,0,0,0,1,1,25220.6793309046
"137",10,15,0,0,25,0,25,6,1,6,2,1,2,0,0,0,3,3,84729.3484580244
"138",3,5,0,0,0,8,8,6,1,4,2,3,0,0,0,0,3,3,539957.475859467
"139",0,5,3,0,1,1,5,6,1,4,2,1,9,8,0,0,2,10,503966.754024673
"140",6,2,1,0,4,3,8,1,2,8,2,4,1,0,0,3,2,5,421584.892117383
"141",2,1,0,0,3,0,3,4,1,5,2,4,5,0,0,7,2,9,97333.632582297
"142",6,6,11,0,0,1,12,5,1,8,4,3,2,0,0,3,2,5,236805.344069727
"143",1,2,0,0,3,0,3,6,2,5,2,0,3,0,0,3,0,3,36504.5025852056
"144",1,2,0,0,3,0,3,6,1,6,2,0,2,0,0,2,0,2,27594.3903864369
"145",0,0,0,0,0,0,0,5,2,3,3,63,32,85,0,10,0,95,127721.552923679
"146",2,3,0,0,3,2,5,2,2,4,2,2,2,0,0,0,4,4,42016.0727912624
"147",1,5,0,0,3,3,6,4,2,8,4,2,17,0,0,14,5,19,527518.497547595
"148",0,11,0,0,10,1,11,5,1,4,2,2,3,0,0,3,2,5,528016.637955316
"149",22,13,0,0,33,2,35,3,2,2,2,0,31,0,0,29,2,31,59222.2889813202
"150",5,0,1,0,3,1,5,6,1,4,1,0,2,0,0,2,0,2,187799.61344461
"151",0,0,0,0,0,0,0,6,1,3,2,0,0,0,0,0,0,0,83410.7624974992
"152",0,2,0,0,0,2,2,3,2,3,2,0,3,0,0,0,3,3,59081.1992620712
"153",4,6,6,0,0,4,10,1,2,1,2,16,0,0,0,12,4,16,42197.3302197331
"154",3,3,3,0,0,3,6,3,2,4,2,5,11,6,0,4,6,16,48420.3684876733
"155",2,0,0,0,2,0,2,4,1,2,2,0,0,0,0,0,0,0,118518.705558094
"156",0,0,0,0,0,0,0,6,2,2,2,0,0,0,0,0,0,0,38906.0352685036
"157",0,7,0,0,3,4,7,6,1,4,2,0,1,0,0,0,1,1,101377.861468654
"158",0,0,0,0,0,0,0,4,2,5,2,4,2,0,0,2,4,6,109727.473010172
"159",0,1,0,0,1,0,1,6,1,1,2,22,20,2,0,0,40,42,28117.7188268967
"160",3,2,0,0,2,3,5,5,1,4,2,3,0,3,0,0,0,3,47271.3528066235
"161",0,0,0,0,0,0,0,5,2,6,2,4,8,12,0,0,0,12,35664.9700664203
"162",1,7,3,0,4,1,8,5,2,6,2,1,0,0,0,0,1,1,37201.5216453405
"163",3,14,0,0,17,0,17,1,2,1,2,13,6,8,0,7,4,19,27015.5462767988
"164",1,0,0,0,0,1,1,4,2,7,2,2,1,0,0,0,3,3,91595.5864582705
"165",1,0,0,0,0,1,1,6,2,1,2,1,0,0,0,0,1,1,88059.9844547988
"166",0,10,0,0,6,4,10,3,1,2,2,145,120,265,0,0,0,265,539957.475859467
"167",0,25,25,0,0,0,25,6,2,4,2,0,2,0,0,0,2,2,61292.4710110294
"168",36,36,0,0,72,0,72,5,1,7,2,0,0,0,0,0,0,0,50771.5886424704
"169",1,2,0,0,2,1,3,5,2,6,2,1,1,0,0,1,1,2,62318.6458881433
"170",4,0,0,0,1,3,4,6,2,2,1,0,1,0,0,0,1,1,240560.617372103
"171",3,2,0,0,1,4,5,4,2,3,2,3,0,0,0,0,3,3,53950.2607736686
"172",1,2,1,0,0,2,3,4,2,1,2,2,0,0,0,0,2,2,119700.647452318
"173",1,13,0,8,3,3,14,1,2,6,2,2,55,49,2,4,2,57,189639.772698041
"174",4,4,0,0,4,4,8,4,2,8,2,4,3,0,0,3,4,7,150987.350220452
"175",7,0,0,0,0,7,7,3,2,8,2,7,0,0,0,0,7,7,96589.9202166141
"176",14,29,23,0,0,20,43,3,1,5,2,10,11,0,0,11,10,21,192564.230517513
"177",0,5,0,0,5,0,5,6,2,3,2,0,3,0,0,3,0,3,14088.7261505038
"178",22,38,0,0,60,0,60,5,2,6,2,15,14,0,0,21,8,29,131294.180100907
"179",1,6,5,0,1,1,7,4,1,3,2,0,4,4,0,0,0,4,82318.4753820567
"180",4,0,1,0,2,1,4,6,1,6,2,3,3,3,0,3,0,6,10439.0641054017
"181",3,0,0,0,0,3,3,3,1,7,4,3,0,0,0,0,3,3,539957.475859467
"182",3,6,2,0,0,7,9,4,1,7,2,2,10,10,0,0,2,12,76612.9595065376
"183",3,6,6,0,0,3,9,3,2,6,2,3,3,3,0,0,3,6,80753.341719182
"184",0,0,0,0,0,0,0,5,2,6,2,1,0,0,0,0,1,1,312380.599380891
"185",1,1,0,0,0,2,2,4,1,5,2,2,0,0,0,0,2,2,72572.8650060776
"186",2,7,0,0,7,2,9,5,2,2,2,3,5,0,0,7,1,8,21755.7293910454
"187",4,15,17,0,0,2,19,5,2,6,2,3,0,0,0,0,3,3,150887.649565122
"188",0,0,0,0,0,0,0,4,1,6,2,0,1,0,0,0,1,1,153651.095630485
"189",0,4,0,0,0,4,4,6,2,3,2,0,6,0,0,6,0,6,24617.7224978222
"190",4,4,4,0,0,4,8,4,2,6,2,16,0,13,0,0,3,16,57828.6601664067
"191",4,6,0,0,8,2,10,2,2,7,2,2,20,18,0,0,4,22,95370.1540706605
"192",37,0,30,0,0,7,37,2,1,7,1,4,14,8,0,2,8,18,453172.801052785
"193",1,0,0,0,0,1,1,6,2,4,2,1,0,0,0,0,1,1,118301.742232588
"194",1,0,0,0,0,1,1,5,1,5,2,1,2,0,0,2,1,3,3448.44203583143
"195",3,10,0,0,10,3,13,5,2,8,2,1,1,0,0,0,2,2,75823.5749696431
"196",1,7,5,0,1,2,8,2,2,4,2,1,5,5,0,0,1,6,56398.1025095868
"197",1,0,0,0,0,1,1,5,1,8,2,1,0,0,0,0,1,1,45575.8258321597
"198",4,1,0,0,0,5,5,3,2,8,2,4,5,0,0,0,9,9,188540.528547599
"199",0,1,1,0,0,0,1,4,1,6,4,0,2,2,0,0,0,2,100121.976570317
"200",5,2,4,0,1,2,7,4,1,8,4,0,6,2,0,4,0,6,345117.171547238
"201",1,4,0,0,3,2,5,6,1,4,2,1,4,0,0,1,4,5,78605.2258117057
"202",0,0,0,0,0,0,0,4,1,1,2,1,0,0,0,0,1,1,150721.105578113
"203",0,1,0,0,0,1,1,2,2,1,1,0,0,0,0,0,0,0,62656.4337445359
"204",0,0,0,0,0,0,0,6,1,4,2,0,2,0,0,2,0,2,25709.0673493223
"205",0,63,60,0,0,3,63,2,2,7,2,2,66,65,0,0,3,68,416956.870903048
"206",0,1,0,0,0,1,1,6,2,4,2,0,0,0,0,0,0,0,34981.0904731581
"207",2,1,0,0,2,1,3,6,1,4,2,1,2,0,0,1,2,3,24959.3650065853
"208",0,0,0,0,0,0,0,6,2,2,3,0,0,0,0,0,0,0,539957.475859467
"209",9,8,0,0,17,0,17,6,1,3,2,0,4,0,0,4,0,4,34062.1548532441
"210",29,3,28,0,0,4,32,3,2,6,2,4,2,0,0,2,4,6,22606.1898141654
"211",1,0,0,0,0,1,1,3,2,3,1,2,0,0,0,0,2,2,65076.464562462
"212",3,5,0,0,5,3,8,3,2,4,2,1,15,15,0,0,1,16,70637.4248816499
"213",3,0,0,0,0,3,3,4,2,3,2,3,3,0,0,3,3,6,18416.3015619037
"214",1,4,0,0,2,3,5,6,1,1,2,0,0,0,0,0,0,0,18578.6098255962
"215",1,2,0,0,2,1,3,6,2,3,2,2,1,0,0,0,3,3,185084.505192524
"216",13,124,124,0,9,4,137,3,1,5,2,4,1,0,0,0,5,5,539957.475859467
"217",4,0,0,0,0,4,4,4,2,6,2,4,2,0,0,2,4,6,539957.475859467
"218",1,7,0,0,6,2,8,6,2,8,2,1,0,0,0,0,1,1,107075.206730796
"219",3,0,0,0,0,3,3,3,2,5,2,3,0,0,0,0,3,3,46027.2657031476
"220",1,23,22,0,1,1,24,2,2,5,2,11,13,17,0,6,1,24,117271.501538318
"221",0,41,41,0,0,0,41,4,2,3,1,0,0,0,0,0,0,0,442526.574141785
"222",13,0,0,0,10,3,13,4,2,6,2,3,3,0,0,2,4,6,43893.5871095495
"223",3,2,0,0,2,3,5,3,2,4,2,45,0,0,0,0,45,45,85293.3675926004
"224",0,0,0,0,0,0,0,6,2,2,2,1,0,0,0,0,1,1,153604.359044416
"225",1,0,0,0,0,1,1,3,1,8,2,2,0,0,0,1,1,2,277659.515880752
"226",11,0,9,0,0,2,11,3,2,3,2,17,3,8,0,10,2,20,25943.4175033578
"227",10,148,145,0,2,11,158,5,2,8,2,3,3,0,0,6,0,6,90893.1835859762
"228",0,16,5,0,10,1,16,2,1,8,2,0,17,12,0,4,1,17,154813.866154854
"229",3,3,0,0,6,0,6,6,1,4,2,0,0,0,0,0,0,0,4742.87023940504
"230",5,0,0,0,0,5,5,6,2,3,2,0,0,0,0,0,0,0,177782.435820418
"231",5,30,34,0,0,1,35,4,2,7,2,1,2,2,0,0,1,3,134097.504864402
"232",37,31,21,0,24,23,68,4,1,3,2,22,44,36,0,22,8,66,7472.77235519588
"233",1,0,0,0,1,0,1,6,1,8,2,5,0,0,0,4,1,5,179139.168169481
"234",0,0,0,0,0,0,0,4,1,7,1,3,5,0,0,8,0,8,199280.561678564
"235",0,0,0,0,0,0,0,6,2,2,2,0,0,0,0,0,0,0,225575.152191033
"236",2,1,0,0,1,2,3,6,1,6,2,3,0,0,0,2,1,3,43700.9556529352
"237",0,6,0,0,6,0,6,6,2,8,2,0,4,0,0,0,4,4,89092.4793695153
"238",1,1,0,0,1,1,2,4,2,5,4,0,2,0,0,2,0,2,45788.3626812092
"239",1,5,0,0,4,2,6,5,1,8,2,1,3,0,0,3,1,4,123391.300476766
"240",0,0,0,0,0,0,0,5,2,4,2,0,0,0,0,0,0,0,14541.7494552305
"241",1,1,0,0,0,2,2,6,2,4,2,1,20,0,0,18,3,21,80557.025509997
"242",0,0,0,0,0,0,0,5,1,1,2,0,0,0,0,0,0,0,75653.3962918919
"243",1,4,0,0,1,4,5,6,1,8,2,1,1,0,0,0,2,2,85832.7087451946
"244",71,127,0,43,23,132,198,5,2,4,3,1,3,0,0,1,3,4,248809.594823466
"245",1,6,4,0,0,3,7,4,1,7,2,2,2,0,0,2,2,4,189313.964002989
"246",0,0,0,0,0,0,0,6,2,4,2,0,1,0,0,0,1,1,56678.4890087866
"247",0,0,0,0,0,0,0,2,1,1,4,0,4,0,0,0,4,4,156196.846476467
"248",2,4,0,0,0,6,6,2,2,5,2,2,1,0,0,1,2,3,52619.2433475878
"249",3,5,5,0,0,3,8,2,1,5,2,3,10,10,0,0,3,13,113710.500391733
"250",21,10,30,0,0,1,31,2,2,2,2,22,16,27,0,10,1,38,196246.568214271
"251",2,7,0,0,7,2,9,5,1,8,2,5,24,25,0,1,3,29,96815.9840562993
"252",6,0,0,0,6,0,6,6,1,6,2,8,9,0,0,11,6,17,151502.286223852
"253",0,1,0,0,1,0,1,5,2,4,2,0,0,0,0,0,0,0,95639.6780398933
"254",0,3,0,0,0,3,3,1,1,6,2,9,0,0,0,6,3,9,244222.28303862
"255",0,2,0,0,0,2,2,6,2,3,2,0,0,0,0,0,0,0,43050.8467941012
"256",0,7,6,0,1,0,7,4,1,4,2,0,7,7,0,0,0,7,177202.707992016
"257",1,0,0,0,0,1,1,6,2,5,3,1,6,0,0,4,3,7,467839.641402906
"258",3,0,0,0,0,3,3,3,2,6,2,3,2,0,0,2,3,5,71061.449019473
"259",0,4,0,0,2,2,4,6,1,4,2,0,0,0,0,0,0,0,72476.1508291641
"260",0,4,0,0,4,0,4,6,2,3,2,0,0,0,0,0,0,0,49129.4102928083
"261",2,1,0,0,0,3,3,5,2,2,2,0,6,4,0,0,2,6,50717.7519492567
"262",2,0,0,0,1,1,2,4,2,3,2,21,0,21,0,0,0,21,25745.6843364139
"263",3,6,0,0,6,3,9,5,2,3,2,0,3,0,0,0,3,3,134584.587154045
"264",4,2,0,0,6,0,6,5,1,2,2,4,2,1,0,5,0,6,10164.9483854312
"265",847,0,842,0,4,1,847,2,2,3,2,12,273,277,0,0,8,285,378110.156299239
"266",2,4,0,0,4,2,6,6,2,6,2,1,0,0,0,0,1,1,64937.3189801233
"267",0,0,0,0,0,0,0,5,2,3,2,0,2,0,0,2,0,2,12987.1594134867
"268",1,1,0,0,1,1,2,4,2,7,2,26,57,80,0,0,3,83,91142.7440167198
"269",4,3,0,0,1,6,7,4,1,1,1,1,3,0,0,3,1,4,355623.624141357
"270",1,10,10,0,0,1,11,4,1,6,2,20,21,29,0,11,1,41,40435.1014187876
"271",0,0,0,0,0,0,0,5,2,4,2,1,0,0,0,0,1,1,25299.8009937157
"272",3,0,0,0,0,3,3,4,2,4,2,3,0,0,0,0,3,3,38487.9961818076
"273",0,0,0,0,0,0,0,5,1,4,2,0,0,0,0,0,0,0,20091.3868293824
"274",4,4,0,0,5,3,8,2,2,2,2,2,1,0,0,2,1,3,65017.9498722929
"275",4,0,0,0,0,4,4,5,2,5,2,3,36,32,0,3,4,39,25085.5155575597
"276",5,2,0,0,3,4,7,6,2,5,2,2,6,0,0,0,8,8,380892.442917989
"277",0,0,0,0,0,0,0,5,1,7,3,0,1,0,0,1,0,1,462033.026635747
"278",0,0,0,0,0,0,0,5,1,3,2,0,2,0,0,2,0,2,56322.7986278978
"279",2,10,11,0,0,1,12,2,2,4,1,0,2,0,0,0,2,2,518753.392527162
"280",15,0,13,0,1,1,15,5,2,4,2,9,36,43,0,0,2,45,347565.168596779
"281",12,1,2,0,0,11,13,5,1,1,2,1,1,0,0,1,1,2,13013.2627382525
"282",63,48,0,0,48,63,111,5,1,6,2,1,0,0,0,0,1,1,157880.607274543
"283",7,0,0,0,3,4,7,4,2,6,2,3,2,0,0,1,4,5,28378.7782733153
"284",0,0,0,0,0,0,0,3,1,3,4,0,0,0,0,0,0,0,539957.475859467
"285",7,14,20,0,0,1,21,2,2,7,2,0,15,11,0,4,0,15,328109.726546048
"286",1,0,0,0,0,1,1,6,1,5,2,10,0,0,0,0,10,10,30264.0056469846
"287",0,6,5,0,0,1,6,5,1,6,2,1,0,0,0,0,1,1,68204.0634937051
"288",5,1,6,0,0,0,6,3,1,2,1,15,20,35,0,0,0,35,227231.594260581
"289",0,1,0,0,0,1,1,5,2,7,2,5,3,0,0,8,0,8,131251.888603755
"290",3,2,0,0,0,5,5,1,2,4,2,4,1,0,0,0,5,5,123880.975647452
"291",1,3,0,0,3,1,4,6,1,6,2,1,0,0,0,0,1,1,33695.6149348611
"292",1,0,0,0,1,0,1,5,2,3,2,1,0,0,0,1,0,1,21755.6205441751
"293",3,4,0,0,4,3,7,5,2,4,2,0,1,0,0,0,1,1,102812.927304368
"294",0,4,4,0,0,0,4,6,2,3,2,0,0,0,0,0,0,0,19726.0261093402
"295",3,3,0,0,0,6,6,4,1,3,2,2,9,9,0,0,2,11,47691.2467882509
"296",4,11,10,0,0,5,15,4,1,4,2,4,0,0,0,0,4,4,217110.696232363
"297",1,1,0,0,1,1,2,2,1,3,2,1,0,0,0,0,1,1,136826.42404077
"298",0,8,0,0,8,0,8,6,1,3,4,0,5,0,0,5,0,5,137089.873160503
"299",0,0,0,0,0,0,0,3,1,8,2,0,5,0,0,2,3,5,83634.9740778826
"300",2,7,4,0,4,1,9,5,1,7,2,1,0,0,0,0,1,1,125458.809665419
"301",1,0,0,0,0,1,1,6,2,3,2,2,0,0,0,0,2,2,49699.0817485117
"302",2,1,1,0,0,2,3,2,1,4,2,0,3,2,0,0,1,3,74532.7316986502
"303",2,3,0,0,3,2,5,4,1,2,2,2,2,0,0,2,2,4,82877.4166260808
"304",0,0,0,0,0,0,0,5,2,4,2,0,3,3,0,0,0,3,64931.8522940322
"305",0,13,8,0,1,4,13,4,2,6,2,3,3,0,0,3,3,6,124648.989195494
"306",1,6,0,0,1,6,7,5,2,6,2,1,1,0,0,1,1,2,59860.0117902882
"307",2,0,0,0,0,2,2,6,2,5,2,2,0,0,0,0,2,2,79874.7198526868
"308",0,13,0,0,13,0,13,6,2,6,1,3,0,0,0,0,3,3,162644.998228168
"309",1,6,0,4,0,3,7,1,1,3,1,3,4,0,0,0,7,7,347792.124457941
"310",1,0,0,0,0,1,1,4,2,6,2,1,0,0,0,0,1,1,60615.0227468293
"311",0,0,0,0,0,0,0,5,1,4,2,0,0,0,0,0,0,0,55086.1140333935
"312",7,3,0,0,9,1,10,6,1,4,2,1,2,0,0,3,0,3,60608.546912661
"313",1,2,0,0,1,2,3,2,2,4,2,2,0,0,0,0,2,2,112553.284251802
"314",1,2,0,0,1,2,3,3,1,8,2,1,2,0,0,1,2,3,194406.266419813
"315",2,8,7,0,3,0,10,3,2,6,2,0,5,0,0,5,0,5,56288.1075331796
"316",2,5,0,0,5,2,7,1,1,1,4,3,0,0,0,2,1,3,539957.475859467
"317",0,0,0,0,0,0,0,4,2,4,2,4,2,2,0,2,2,6,98588.4474888842
"318",2,0,0,0,0,2,2,6,2,2,2,0,2,0,0,1,1,2,57521.8161640295
"319",2,1,0,0,1,2,3,6,1,6,2,18,0,0,0,16,2,18,17087.691505353
"320",1,0,0,0,0,1,1,3,2,4,2,1,0,0,0,0,1,1,59086.0326686464
"321",5,1,0,0,5,1,6,5,2,7,2,3,3,0,0,5,1,6,55161.1005553603
"322",4,4,0,0,4,4,8,3,1,3,2,12,8,2,0,8,10,20,93088.3421770604
"323",1,3,0,0,2,2,4,2,2,4,2,10,4,0,0,14,0,14,275803.183167903
"324",5,1,3,0,1,2,6,3,1,3,2,0,5,5,0,0,0,5,104923.22134175
"325",1,3,0,0,4,0,4,6,2,3,2,3,0,0,0,3,0,3,45030.0353530303
"326",3,0,0,0,1,2,3,1,1,3,2,4,5,0,0,1,8,9,197725.912293864
"327",0,1,0,0,1,0,1,6,1,4,2,1,0,0,0,0,1,1,60608.546912661
"328",9,0,0,0,8,1,9,6,1,4,2,3,0,0,0,1,2,3,61675.6793997878
"329",1,3,3,0,0,1,4,4,2,5,2,3,8,0,0,6,5,11,91082.2577119556
"330",1,0,0,0,0,1,1,6,2,5,2,4,0,0,0,0,4,4,60887.4859165645
"331",1,0,0,0,0,1,1,6,2,3,2,0,3,0,0,0,3,3,31170.9499127375
"332",5,8,0,0,12,1,13,6,2,8,2,6,2,0,0,6,2,8,85798.6892906742
"333",0,4,0,0,4,0,4,4,2,7,2,5,0,0,0,0,5,5,212817.250319577
"334",0,5,4,0,0,1,5,2,2,3,2,3,8,11,0,0,0,11,77634.8840623479
"335",0,11,0,0,5,6,11,6,2,7,2,0,5,0,0,5,0,5,52920.617722933
"336",4,6,0,0,7,3,10,5,2,3,5,3,2,0,0,0,5,5,109745.880451995
"337",1,1,0,0,1,1,2,5,2,5,2,1,0,0,0,0,1,1,73123.9476805581
"338",3,7,9,0,0,1,10,4,1,6,2,1,0,1,0,0,0,1,134497.913719528
"339",6,0,6,0,0,0,6,2,2,3,2,12,0,0,0,12,0,12,539957.475859467
"340",14,0,0,0,11,3,14,6,2,5,2,4,20,0,0,21,3,24,140599.762149276
"341",2,4,0,0,3,3,6,2,1,4,2,4,0,0,0,0,4,4,279751.516281413
"342",2,1,0,0,2,1,3,6,2,3,2,1,1,0,0,1,1,2,41459.2371199782
"343",0,1,0,0,0,1,1,5,1,3,2,0,3,0,0,3,0,3,96680.23142128
"344",1,2,2,0,0,1,3,1,2,6,2,2,1,1,0,1,1,3,112824.759083297
"345",4,0,0,0,4,0,4,5,2,3,5,0,0,0,0,0,0,0,112654.52951661
"346",1,6,0,0,0,7,7,5,2,2,2,2,10,5,0,5,2,12,16873.5251224335
"347",0,2,0,0,2,0,2,4,2,7,5,1,0,0,0,0,1,1,206815.767493585
"348",1,0,0,0,0,1,1,5,1,6,2,2,0,0,0,0,2,2,34753.1838594004
"349",30,4,10,10,6,8,34,4,2,2,2,19,5,20,0,0,4,24,12363.960336397
"350",0,0,0,0,0,0,0,2,2,6,4,2,0,0,0,0,2,2,372249.510019856
"351",1,2,0,0,0,3,3,3,2,4,2,0,1,0,0,1,0,1,25112.8911714361
"352",4,4,0,0,4,4,8,6,1,5,2,4,1,0,0,1,4,5,46981.814702086
"353",0,2,0,0,2,0,2,6,2,3,2,0,1,0,0,0,1,1,141814.988989979
"354",8,3,0,7,0,4,11,1,2,1,2,0,17,10,0,5,2,17,45380.1963055808
"355",4,2,0,0,5,1,6,4,2,7,2,5,0,0,0,4,1,5,83915.2935663945
"356",4,4,0,0,5,3,8,4,1,3,2,0,3,0,0,2,1,3,68434.0805459928
"357",1,0,0,0,0,1,1,6,2,3,2,1,0,0,0,0,1,1,20346.5408393738
"358",1,1,1,0,1,0,2,5,1,8,2,2,23,22,0,0,3,25,69458.4609637584
"359",1,3,0,0,0,4,4,2,1,4,2,0,2,0,0,0,2,2,215702.362321884
"360",1,19,16,0,3,1,20,3,1,8,2,1,2,0,0,2,1,3,124709.497179787
"361",0,0,0,0,0,0,0,5,2,4,2,0,5,0,0,5,0,5,56112.2148746024
"362",6,33,33,0,2,4,39,1,2,6,2,3,2,0,0,0,5,5,189639.772698041
"363",0,1,0,0,0,1,1,4,2,6,3,0,1,0,0,1,0,1,213821.120045205
"364",0,2,0,0,0,2,2,5,2,5,2,0,5,0,0,3,2,5,68159.3731620281
"365",0,15,0,0,15,0,15,4,2,8,1,0,50,50,0,0,0,50,196890.806633041
"366",0,0,0,0,0,0,0,4,1,2,2,0,0,0,0,0,0,0,416101.465205095
"367",1,0,0,0,0,1,1,5,2,8,2,1,7,0,0,7,1,8,98025.5308476592
"368",0,2,2,0,0,0,2,4,2,4,2,0,1,0,0,1,0,1,59275.446248702
"369",0,0,0,0,0,0,0,2,1,8,2,2,0,0,0,0,2,2,134021.519238188
"370",4,5,0,0,5,4,9,4,2,6,2,2,5,3,0,2,2,7,37931.5590806654
"371",3,0,0,0,1,2,3,6,1,8,2,1,0,0,0,0,1,1,100235.44438602
"372",0,2,0,0,1,1,2,6,1,6,2,0,0,0,0,0,0,0,539957.475859467
"373",9,23,19,0,13,0,32,6,1,4,2,0,171,125,0,46,0,171,40569.7981328356
"374",2,0,0,0,0,2,2,4,2,7,2,2,4,3,0,1,2,6,105261.079364233
"375",0,2,0,0,0,2,2,4,1,8,4,0,1,0,0,1,0,1,209128.576667728
"376",1,1,0,1,0,1,2,3,1,8,2,1,2,0,0,1,2,3,111727.032539349
"377",1,0,0,0,0,1,1,6,1,6,2,3,3,0,0,6,0,6,34288.8924048279
"378",8,0,0,0,3,5,8,2,2,5,2,5,8,0,0,8,5,13,34753.161986793
"379",2,14,14,0,0,2,16,2,2,4,2,2,2,0,0,0,4,4,43741.8016398377
"380",0,6,0,0,6,0,6,6,2,8,2,4,1,0,0,1,4,5,89092.4793695153
"381",0,0,0,0,0,0,0,4,1,4,1,3,0,0,0,0,3,3,239219.820037065
"382",0,0,0,0,0,0,0,4,1,8,2,0,0,0,0,0,0,0,240735.571459862
"383",1,1,0,0,1,1,2,6,1,8,2,1,2,0,0,3,0,3,94021.6115764588
"384",0,4,0,0,4,0,4,5,1,6,2,0,0,0,0,0,0,0,101673.151858057
"385",1,0,0,0,0,1,1,2,1,5,2,13,9,0,0,22,0,22,89220.179627111
"386",1,10,10,0,0,1,11,5,2,7,2,3,0,0,0,0,3,3,16159.4354141326
"387",2,5,0,1,4,2,7,1,2,2,2,1,1,0,0,1,1,2,71865.8083772307
"388",0,1,0,0,0,1,1,6,2,5,2,2,0,0,0,0,2,2,61068.9758697734
"389",3,4,0,0,4,3,7,6,1,3,2,3,12,0,0,14,1,15,49183.6442662641
"390",3,1,0,0,2,2,4,3,2,1,2,2,4,0,0,0,6,6,38023.9057695493
"391",1,2,0,0,2,1,3,2,1,5,2,1,5,0,0,4,2,6,215691.110580116
"392",11,11,0,0,13,9,22,3,2,6,5,9,1,0,0,2,8,10,246311.874754997
"393",1,0,0,0,0,1,1,6,1,6,2,1,0,0,0,0,1,1,107986.967200634
"394",4,0,1,0,2,1,4,2,1,6,2,4,1,0,0,0,5,5,22942.7291600797
"395",0,0,0,0,0,0,0,6,1,2,2,1,6,0,0,5,2,7,58914.752026875
"396",0,0,0,0,0,0,0,6,2,3,2,0,0,0,0,0,0,0,147924.794909942
"397",63,400,463,0,0,0,463,5,2,3,2,12,40,52,0,0,0,52,163566.238263153
"398",2,10,10,0,0,2,12,2,2,6,2,0,12,9,0,3,0,12,215026.135259857
"399",1,1,0,0,0,2,2,5,1,3,2,3,4,0,0,5,2,7,29981.2987366429
"400",4,11,12,0,0,3,15,5,1,4,2,1,13,14,0,0,0,14,400779.54818062
"401",6,5,1,0,7,3,11,3,2,2,2,3,2,1,0,4,0,5,59222.2889813202
"402",3,8,0,0,0,11,11,1,1,8,1,14,13,0,0,19,8,27,539957.475859467
"403",1,1,0,0,0,2,2,6,1,6,2,1,1,0,0,1,1,2,26637.5407038979
"404",1,0,0,0,0,1,1,6,2,4,2,0,0,0,0,0,0,0,370793.605857675
"405",7,20,27,0,0,0,27,2,1,1,2,10,8,0,6,12,0,18,19057.3542465072
"406",15,7,0,0,22,0,22,5,1,8,2,6,28,0,0,34,0,34,232793.517394679
"407",0,10,6,0,0,4,10,3,1,4,1,0,0,0,0,0,0,0,60963.1620611005
"408",3,0,0,0,0,3,3,3,1,6,4,3,4,4,0,0,3,7,139648.748186307
"409",2,1,0,0,1,2,3,3,2,7,2,2,0,0,0,0,2,2,140733.156399215
"410",4,7,0,0,7,4,11,1,2,7,2,9,9,13,1,0,4,18,98746.5572993561
"411",3,0,0,0,0,3,3,2,1,6,2,4,2,0,0,4,2,6,124999.375127992
"412",2,3,0,0,3,2,5,3,1,7,2,0,0,0,0,0,0,0,109173.446602106
"413",3,1,0,0,4,0,4,6,2,3,2,0,3,0,0,3,0,3,23646.4887509703
"414",2,0,0,0,1,1,2,6,2,4,2,0,0,0,0,0,0,0,36911.4688057359
"415",2,24,24,0,1,1,26,5,2,3,2,11,0,0,0,9,2,11,26146.8485758787
"416",1,0,0,0,0,1,1,3,1,5,2,18,6,21,0,0,3,24,165502.185564041
"417",0,1,0,0,0,1,1,5,2,5,2,1,0,0,0,0,1,1,40364.4579745049
"418",0,0,0,0,0,0,0,6,2,4,2,5,2,0,0,0,7,7,22880.4422782939
"419",3,0,0,0,0,3,3,3,2,8,2,3,1,0,0,0,4,4,112550.49678674
"420",9,7,0,0,15,1,16,5,2,6,2,3,45,47,0,0,1,48,31033.7063151949
"421",0,3,0,0,0,3,3,6,2,3,2,0,0,0,0,0,0,0,35735.5201468527
"422",32,3,31,0,0,4,35,4,2,8,2,1,10,10,0,0,1,11,102814.139452675
"423",1,0,0,0,0,1,1,3,1,5,1,5,0,0,0,5,0,5,128298.426213699
"424",1,3,0,0,3,1,4,6,1,7,2,1,4,0,0,4,1,5,64967.6502137946
"425",5,11,0,10,1,5,16,1,2,6,1,7,39,42,0,0,4,46,500109.977456928
"426",0,0,0,0,0,0,0,4,1,4,2,0,0,0,0,0,0,0,26677.0915421792
"427",1,1,0,0,0,2,2,1,2,3,1,1,1,0,0,1,1,2,528726.612144053
"428",2,3,2,0,2,1,5,5,2,2,2,5,14,6,0,10,3,19,49186.1036464756
"429",2,2,0,0,0,4,4,2,1,5,2,1,3,0,0,0,4,4,211509.596780687
"430",2,0,0,0,0,2,2,4,2,8,2,2,0,0,0,0,2,2,165435.587783714
"431",1,4,4,0,0,1,5,4,2,8,2,1,1,1,0,0,1,2,106507.336125348
"432",3,1,0,0,2,2,4,3,1,4,2,2,4,0,0,2,4,6,21662.0639387054
"433",0,0,0,0,0,0,0,5,2,3,2,0,4,4,0,0,0,4,125327.316051081
"434",0,2,0,0,1,1,2,6,2,7,2,3,1,0,0,0,4,4,174769.123069249
"435",1,0,0,0,0,1,1,6,1,4,2,1,0,0,0,0,1,1,60608.546912661
"436",0,0,0,0,0,0,0,6,1,2,2,0,2,0,0,0,2,2,47221.1899385032
"437",3,0,0,0,0,3,3,2,1,5,3,3,6,4,0,1,4,9,188971.050321694
"438",0,2,0,0,0,2,2,5,2,6,2,1,3,0,0,3,1,4,501626.705061199
"439",6,0,0,0,3,3,6,3,1,6,1,4,1,0,0,3,2,5,113021.956627655
"440",1,1,0,0,1,1,2,6,1,8,2,1,0,0,0,0,1,1,232777.219629709
"441",2,0,0,0,0,2,2,6,1,2,2,0,3,0,0,0,3,3,66249.8301355389
"442",3,9,0,0,0,12,12,6,1,3,2,0,1,0,0,0,1,1,308059.583140842
"443",3,1,0,0,0,4,4,2,1,2,2,6,1,3,0,0,4,7,107616.057224421
"444",153,191,0,0,0,344,344,4,2,8,2,3,1,0,0,1,3,4,102814.139452675
"445",0,2,0,0,1,1,2,5,1,6,2,0,2,0,0,0,2,2,69404.9299657735
"446",0,0,0,0,0,0,0,4,1,6,3,10,0,10,0,0,0,10,539957.475859467
"447",0,3,0,0,3,0,3,6,2,3,2,0,0,0,0,0,0,0,45114.4270745555
"448",3,11,6,0,4,4,14,4,2,6,2,6,18,21,0,2,1,24,70143.1080382926
"449",1,8,3,0,4,2,9,4,2,3,2,1,2,0,0,1,2,3,84526.9787242827
"450",1,0,0,0,0,1,1,5,1,5,2,1,0,0,0,0,1,1,10047.7538602727
"451",3,6,4,0,0,5,9,4,2,5,1,0,35,35,0,0,0,35,388977.563891589
"452",2,7,0,0,7,2,9,2,1,5,2,2,0,0,0,0,2,2,478655.477134861
"453",1,0,0,0,0,1,1,5,1,8,2,3,1,0,0,2,2,4,57651.9242016222
"454",0,2,0,0,2,0,2,6,2,3,2,0,1,0,0,1,0,1,23716.9728590323
"455",1,0,0,0,1,0,1,5,1,3,2,0,0,0,0,0,0,0,49590.6529508145
"456",12,0,0,0,12,0,12,3,2,6,4,4,2,0,0,2,4,6,171989.033861537
"457",4,3,0,0,0,7,7,3,2,6,2,4,1,0,0,0,5,5,61833.786348215
"458",0,0,0,0,0,0,0,3,2,3,2,1,0,0,0,0,1,1,259346.909791225
"459",0,1,0,0,0,1,1,5,2,4,2,0,0,0,0,0,0,0,57067.7215935354
"460",0,0,0,0,0,0,0,3,2,5,4,0,1,0,0,1,0,1,131791.570433716
"461",16,0,13,0,0,3,16,5,2,2,2,0,26,24,0,0,2,26,35770.4144883946
"462",2,2,0,0,3,1,4,5,2,3,2,14,0,0,0,0,14,14,26146.8485758787
"463",2,7,0,0,9,0,9,6,2,8,2,0,3,0,0,3,0,3,26099.6273055092
"464",0,0,0,0,0,0,0,6,2,4,1,1,0,0,0,0,1,1,120025.636565433
"465",0,1,0,0,1,0,1,6,1,6,2,0,1,0,0,1,0,1,87274.3567553429
"466",0,0,0,0,0,0,0,2,1,3,1,0,20,20,0,0,0,20,77076.3466376032
"467",0,2,0,0,0,2,2,6,2,7,1,0,0,0,0,0,0,0,166916.00813436
"468",2,17,0,0,15,4,19,5,2,4,2,10,0,0,0,9,1,10,39192.9710772864
"469",2,0,0,0,0,2,2,5,1,8,2,2,0,0,0,0,2,2,190311.29059784
"470",3,3,0,1,2,3,6,4,1,5,2,2,0,0,0,0,2,2,92493.6133192364
"471",0,1,0,0,0,1,1,6,1,2,2,1,0,0,0,0,1,1,11585.7349991423
"472",7,0,4,0,0,3,7,2,1,5,2,4,1,0,0,0,5,5,12377.2173257381
"473",4,0,0,0,3,1,4,6,2,6,2,0,1,0,0,0,1,1,67735.0092578364
"474",2,3,0,0,4,1,5,2,2,8,2,2,2,0,0,3,1,4,34455.5659083971
"475",0,2,0,0,2,0,2,2,1,3,2,0,0,0,0,0,0,0,37777.452040754
"476",5,0,0,0,2,3,5,4,2,3,2,4,2,0,0,2,4,6,31958.5009104617
"477",0,2,0,0,2,0,2,4,2,3,3,1,3,0,0,4,0,4,105882.451763579
"478",0,10,10,0,0,0,10,5,1,6,2,1,11,11,0,0,1,12,21691.730541642
"479",1,0,0,0,0,1,1,3,2,1,2,4,4,7,0,0,1,8,143904.034783353
"480",1,0,0,0,0,1,1,4,2,5,2,2,2,0,0,1,3,4,39456.260451474
"481",0,1,0,0,0,1,1,3,2,7,2,0,0,0,0,0,0,0,57002.4788389471
"482",7,11,12,0,0,6,18,3,2,4,2,22,18,36,0,0,4,40,88532.7342059898
"483",0,5,5,0,0,0,5,1,2,4,2,10,15,12,10,0,3,25,117346.68598595
"484",4,6,5,0,0,5,10,5,1,6,2,4,3,0,0,4,3,7,13588.9862302899
"485",7,4,0,0,4,7,11,4,2,3,2,5,5,2,0,5,3,10,55888.213322217
"486",2,0,0,0,0,2,2,4,2,8,2,2,1,0,0,1,2,3,111095.984740087
"487",3,0,0,0,0,3,3,3,2,8,2,3,3,0,0,3,3,6,116593.434095297
"488",1,1,0,0,0,2,2,2,2,4,2,1,1,0,0,0,2,2,67606.9822262656
"489",0,3,0,0,2,1,3,5,1,3,2,0,0,0,0,0,0,0,73633.3500026217
"490",0,0,0,0,0,0,0,4,1,4,2,1,1,0,0,2,0,2,34231.2914039246
"491",0,0,0,0,0,0,0,2,1,4,2,0,3,0,0,3,0,3,32796.4852858267
"492",5,0,2,0,0,3,5,3,1,7,2,3,0,0,0,0,3,3,311578.341876502
"493",6,61,62,0,2,3,67,2,2,3,2,12,1,8,0,3,2,13,186060.032920738
"494",3,1,0,0,3,1,4,6,2,5,3,1,0,0,0,0,1,1,205401.658933978
"495",7,2,0,0,9,0,9,2,2,3,4,0,9,0,0,7,2,9,67573.5981402303
"496",0,0,0,0,0,0,0,6,1,5,2,72,0,0,0,0,72,72,46981.814702086
"497",0,0,0,0,0,0,0,6,2,6,2,0,0,0,0,0,0,0,35025.893606413
"498",0,2,0,0,1,1,2,5,2,1,2,3,2,0,0,2,3,5,103742.02683089
"499",2,0,0,0,0,2,2,2,2,6,2,0,2,0,0,2,0,2,51459.5689448499
"500",0,0,0,0,0,0,0,6,1,6,2,1,0,0,0,0,1,1,33695.6149348611
"501",0,3,0,0,0,3,3,6,2,1,3,1,1,0,0,2,0,2,357062.249610119
"502",1,3,3,0,0,1,4,2,2,4,2,5,6,0,0,11,0,11,143555.757090804
"503",0,1,0,0,0,1,1,5,2,4,2,0,6,0,0,6,0,6,71191.3167157511
"504",0,3,0,0,1,2,3,2,1,1,2,0,3,0,0,0,3,3,84269.7529997405
"505",0,1,0,0,1,0,1,6,1,4,2,1,0,0,0,0,1,1,539957.475859467
"506",3,3,0,0,3,3,6,4,1,6,2,3,0,0,0,0,3,3,99916.8989653812
"507",3,0,0,0,0,3,3,3,1,6,2,3,22,19,0,0,6,25,30730.6615632582
"508",0,6,0,4,1,1,6,3,2,8,2,2,1,0,1,0,2,3,15919.374860753
"509",3,0,0,0,0,3,3,5,2,6,2,1,1,0,0,0,2,2,100357.950652932
"510",4,20,0,0,24,0,24,6,1,5,2,1,0,0,0,0,1,1,24050.7507662015
"511",0,0,0,0,0,0,0,6,2,6,2,2,1,0,0,2,1,3,353476.42204217
"512",2,0,0,0,0,2,2,5,1,8,3,0,1,0,0,1,0,1,307048.140019835
"513",2,21,21,0,0,2,23,3,2,4,2,1,5,0,0,4,2,6,54006.5142457623
"514",1,0,0,0,0,1,1,6,1,5,2,1,0,0,0,0,1,1,130826.441584726
"515",0,0,0,0,0,0,0,2,2,6,2,1,1,0,0,1,1,2,98436.7880792875
"516",2,6,3,0,5,0,8,3,1,4,1,2,0,0,0,2,0,2,246550.984213099
"517",27,0,27,0,0,0,27,5,2,5,2,0,4,0,0,3,1,4,29229.6733390612
"518",0,0,0,0,0,0,0,1,2,1,2,0,0,0,0,0,0,0,89100.4828264956
"519",0,1,0,0,0,1,1,6,2,3,2,2,2,0,0,2,2,4,28912.3740552863
"520",0,0,0,0,0,0,0,6,2,3,2,1,0,0,0,0,1,1,236554.10781663
"521",0,1,0,0,1,0,1,6,2,3,2,6,1,0,0,7,0,7,127832.297770921
"522",3,0,0,0,0,3,3,4,1,7,2,2,0,0,0,0,2,2,244744.684933705
"523",2,2,0,0,2,2,4,2,1,5,4,0,1,0,0,1,0,1,156963.559263327
"524",12,68,23,40,15,2,80,3,1,6,2,2,15,15,0,0,2,17,60175.0837838487
"525",4,4,0,0,7,1,8,6,1,6,2,0,0,0,0,0,0,0,84729.3484580244
"526",0,2,0,0,0,2,2,1,2,3,1,3,0,0,0,1,2,3,174357.226852515
"527",1,6,0,0,6,1,7,5,2,7,2,1,6,0,0,6,1,7,104242.51926666
"528",0,4,2,0,0,2,4,2,2,8,2,1,0,0,0,1,0,1,112995.88293219
"529",1,0,0,0,0,1,1,5,2,3,2,2,2,1,0,2,1,4,39794.7601496436
"530",0,0,0,0,0,0,0,5,2,5,2,7,8,0,0,14,1,15,56561.9903415748
"531",1,1,0,0,1,1,2,5,2,2,2,1,0,0,0,0,1,1,38045.8660621702
"532",1,2,0,0,2,1,3,6,1,5,2,3,1,0,0,0,4,4,76831.5629184221
"533",0,20,0,0,20,0,20,6,2,3,2,2,1,0,0,1,2,3,56642.8009839457
"534",21,4,12,0,9,4,25,3,2,4,2,12,1,0,0,9,4,13,70637.4248816499
"535",6,15,0,0,10,11,21,6,1,6,2,4,6,0,0,0,10,10,42224.4308975236
"536",4,20,23,0,0,1,24,5,2,4,2,3,67,60,0,7,3,70,57045.1540518195
"537",1,0,0,0,0,1,1,6,1,3,2,1,0,0,0,0,1,1,134325.034854621
"538",0,0,0,0,0,0,0,6,2,5,2,0,5,0,0,5,0,5,27738.7849271811
"539",0,5,0,0,5,0,5,4,2,4,2,1,7,0,0,0,8,8,32024.1362169179
"540",0,1,0,0,0,1,1,6,2,5,2,1,2,0,0,0,3,3,64003.1103376731
"541",4,9,2,0,9,2,13,3,2,2,2,9,4,0,0,9,4,13,62802.3791508632
"542",5,35,23,0,14,3,40,6,1,6,2,2,4,0,0,4,2,6,34288.8924048279
"543",4,6,0,0,7,3,10,6,2,4,2,3,6,0,0,6,3,9,26077.1888090843
"544",0,0,0,0,0,0,0,6,2,2,2,0,0,0,0,0,0,0,281123.073236639
"545",0,2,0,0,2,0,2,6,1,4,2,1,4,4,0,0,1,5,189139.132995022
"546",0,0,0,0,0,0,0,6,2,5,2,5,2,0,0,6,1,7,53642.7956687373
"547",1,3,0,0,2,2,4,6,2,4,1,2,0,0,0,1,1,2,66227.2119849749
"548",0,1,0,0,1,0,1,6,1,6,1,1,0,0,0,1,0,1,183206.169127419
"549",1,0,0,0,0,1,1,1,1,2,2,3,0,0,0,0,3,3,539957.475859467
"550",3,0,0,0,0,3,3,3,2,2,2,3,0,0,0,0,3,3,109861.688048376
"551",2,0,0,0,0,2,2,6,2,1,2,1,4,0,0,4,1,5,26949.6583138284
"552",8,27,24,0,6,5,35,2,2,3,1,1,1,0,0,0,2,2,539957.475859467
"553",4,0,0,0,2,2,4,1,1,2,1,6,0,2,0,0,4,6,539957.475859467
"554",0,54,0,0,50,4,54,5,2,1,3,0,4,0,0,0,4,4,426802.453496928
"555",1,0,0,0,0,1,1,6,1,8,2,10,9,0,0,11,8,19,231590.730793812
"556",0,2,0,0,2,0,2,5,2,4,2,0,2,0,0,2,0,2,28691.8749384339
"557",10,6,0,0,6,10,16,3,2,1,2,6,0,0,0,1,5,6,29491.2355551131
"558",0,17,0,10,5,2,17,1,1,1,2,7,20,0,15,10,2,27,130811.730973027
"559",2,21,20,0,0,3,23,3,2,4,2,0,3,0,0,0,3,3,460204.945280639
"560",1,0,0,0,1,0,1,6,2,2,2,1,5,0,0,4,2,6,59915.6117685946
"561",1,5,0,0,4,2,6,6,2,5,2,1,10,0,0,10,1,11,31075.2458980517
"562",1,0,0,0,0,1,1,5,2,6,2,6,5,0,0,10,1,11,43922.1649100495
"563",2,0,0,0,0,2,2,5,2,3,2,2,0,0,0,0,2,2,235912.454040135
"564",4,134,136,0,0,2,138,4,2,5,2,1,2,0,0,0,3,3,34761.5620088379
"565",4,3,0,0,6,1,7,4,2,5,2,0,0,0,0,0,0,0,349904.631610825
"566",2,3,0,0,2,3,5,6,1,3,5,12,8,0,0,20,0,20,329478.66022677
"567",5,0,5,0,0,0,5,3,1,2,2,0,2,0,0,2,0,2,302989.600924529
"568",9,1,0,0,9,1,10,3,2,7,2,2,0,0,0,0,2,2,329667.312997373
"569",0,13,0,0,3,10,13,6,2,4,2,0,3,0,0,2,1,3,78955.7971255386
"570",16,17,29,0,0,4,33,2,2,4,2,12,15,25,0,0,2,27,56398.1025095868
"571",0,0,0,0,0,0,0,5,2,5,2,14,5,19,0,0,0,19,82902.7302814314
"572",5,3,0,0,7,1,8,5,1,5,2,47,5,35,0,15,2,52,65013.7310215204
"573",4,2,0,0,2,4,6,5,1,4,1,8,3,0,0,3,8,11,140648.371484225
"574",1,11,0,0,10,2,12,6,1,2,2,1,2,0,0,2,1,3,60836.4416476675
"575",1,6,6,0,0,1,7,4,2,7,2,4,15,16,0,1,2,19,228801.154883204
"576",3,6,4,0,4,1,9,4,1,5,2,3,3,0,0,4,2,6,295523.588508656
"577",1,4,0,0,2,3,5,4,2,7,2,0,2,0,0,2,0,2,71250.5857196285
"578",4,1,0,0,1,4,5,3,2,6,2,1,5,0,5,0,1,6,61833.786348215
"579",24,3,21,0,0,6,27,6,2,8,2,13,12,23,0,0,2,25,113037.543122878
"580",4,5,0,0,6,3,9,1,2,2,2,7,13,19,0,0,1,20,194461.700795404
"581",29,38,21,0,28,18,67,2,1,4,2,24,0,0,0,20,4,24,85657.0385233526
"582",7,0,0,0,0,7,7,2,2,4,2,2,6,0,0,8,0,8,103259.310451582
"583",0,0,0,0,0,0,0,6,2,8,2,0,0,0,0,0,0,0,89092.4793695153
"584",2,12,14,0,0,0,14,5,1,5,2,0,1,0,0,1,0,1,27392.2256745593
"585",28,40,0,0,67,1,68,6,1,3,2,4,0,0,0,4,0,4,59874.3894891051
"586",4,0,0,0,0,4,4,3,2,6,1,3,0,0,0,0,3,3,54108.8592319027
"587",0,0,0,0,0,0,0,3,1,1,3,2,0,0,0,1,1,2,536418.858095299
"588",1,82,0,82,0,1,83,5,2,8,2,1,0,0,0,0,1,1,75823.5749696431
"589",0,0,0,0,0,0,0,5,2,5,2,0,2,0,0,2,0,2,26992.0316953169
"590",0,2,0,0,0,2,2,5,1,6,5,0,0,0,0,0,0,0,390625.509793027
"591",2,62,30,30,0,4,64,4,2,7,2,2,8,0,8,0,2,10,79183.7111752654
"592",1,2,0,0,0,3,3,6,1,5,2,1,0,0,0,0,1,1,340028.897084871
"593",1,0,0,0,0,1,1,5,2,7,2,0,3,0,0,3,0,3,539957.475859467
"594",1,1,0,0,1,1,2,6,1,4,2,0,0,0,0,0,0,0,78354.5989148203
"595",2,1,0,0,1,2,3,3,2,3,2,2,6,4,0,0,4,8,60211.8311158054
"596",1,3,0,0,2,2,4,1,2,2,1,0,12,0,12,0,0,12,71606.0558999764
"597",0,5,0,0,5,0,5,4,1,2,2,2,0,0,0,0,2,2,28474.3916768401
"598",1,2,0,0,1,2,3,6,1,6,2,0,0,0,0,0,0,0,211859.778401839
"599",1,1,0,0,0,2,2,6,1,1,2,0,2,0,0,2,0,2,11302.7476284999
"600",4,5,0,0,4,5,9,6,2,6,2,2,0,0,0,0,2,2,38140.9076437047
"601",6,1,0,0,1,6,7,6,2,6,2,2,0,0,0,0,2,2,74588.0629382313
"602",22,0,20,0,0,2,22,2,2,7,2,8,0,8,0,0,0,8,180228.911734595
"603",0,0,0,0,0,0,0,6,2,3,2,0,1,0,0,1,0,1,28998.5544146074
"604",4,8,12,0,0,0,12,5,2,6,2,3,4,0,0,7,0,7,28045.7301434121
"605",12,2,6,2,0,6,14,3,1,8,2,2,6,0,0,5,3,8,124984.372906854
"606",0,2,0,0,2,0,2,1,1,4,3,0,0,0,0,0,0,0,539957.475859467
"607",7,5,0,0,8,4,12,5,1,3,3,2,0,0,0,0,2,2,362061.525251783
"608",5,3,0,0,7,1,8,6,2,4,2,0,1,0,0,1,0,1,54101.0230406294
"609",6,0,0,0,0,6,6,3,2,6,2,2,3,0,0,0,5,5,539957.475859467
"610",4,10,7,0,4,3,14,4,1,6,4,5,5,6,0,1,3,10,244420.20569742
"611",5,0,0,0,0,5,5,5,2,8,2,6,1,0,0,1,6,7,312721.922762037
"612",2,0,0,0,0,2,2,3,2,8,4,2,2,0,0,2,2,4,539957.475859467
"613",3,0,0,0,0,3,3,3,2,8,5,2,20,20,0,0,2,22,318204.770551881
"614",3,1,0,0,1,3,4,4,1,4,2,3,0,0,0,0,3,3,154553.493253532
"615",2,2,0,1,1,2,4,3,2,5,2,2,1,0,0,0,3,3,117150.672987151
"616",11,1,6,0,5,1,12,4,2,3,3,1,7,0,0,7,1,8,136946.544486342
"617",0,1,0,0,0,1,1,6,2,4,2,0,8,0,0,8,0,8,27975.7351151458
"618",0,0,0,0,0,0,0,6,2,4,2,0,1,0,0,1,0,1,30712.3784625643
"619",5,1,0,0,2,4,6,4,2,7,2,3,0,0,0,0,3,3,100705.045676917
"620",2,2,0,0,2,2,4,3,1,5,2,0,0,0,0,0,0,0,101302.940631919
"621",1,2,0,0,2,1,3,6,2,3,2,0,1,0,0,0,1,1,47129.9354180216
"622",0,4,0,0,2,2,4,1,1,1,2,2,4,0,6,0,0,6,22666.3043535706
"623",0,2,2,0,0,0,2,5,1,4,2,0,0,0,0,0,0,0,539957.475859467
"624",3,1,0,0,2,2,4,4,2,4,2,4,7,8,0,0,3,11,67595.8257285069
"625",3,6,0,0,0,9,9,3,2,6,2,4,1,0,0,1,4,5,133093.764776344
"626",3,0,0,0,0,3,3,4,1,5,2,3,0,0,0,0,3,3,44676.5184150448
"627",3,4,0,0,7,0,7,5,1,3,2,0,0,0,0,0,0,0,57314.4721004255
"628",1,15,15,0,0,1,16,2,2,5,2,1,11,10,0,0,2,12,163571.730530172
"629",5,142,142,0,0,5,147,3,1,5,2,121,11,131,0,0,1,132,539957.475859467
"630",1,3,0,0,3,1,4,6,2,8,2,1,1,0,0,1,1,2,188616.708523288
"631",0,1,0,0,0,1,1,4,2,2,2,0,0,0,0,0,0,0,21358.2734154557
"632",1,1,0,0,0,2,2,5,1,8,2,0,1,0,0,0,1,1,29303.5349415179
"633",5,10,10,0,0,5,15,3,1,5,1,6,20,26,0,0,0,26,447523.624633997
"634",0,3,0,0,3,0,3,3,1,6,4,3,1,0,0,0,4,4,357449.918061832
"635",0,3,1,0,2,0,3,2,2,3,2,0,2,0,0,2,0,2,42784.4009953084
"636",3,4,0,0,5,2,7,4,1,5,2,3,5,0,0,6,2,8,59447.4718367695
"637",1,0,0,0,0,1,1,6,2,3,2,1,2,0,0,2,1,3,148307.049207538
"638",1,5,0,0,0,6,6,6,2,5,2,1,1,0,0,0,2,2,123591.125226468
"639",1,2,0,0,0,3,3,4,2,4,4,1,1,0,0,1,1,2,117779.55124832
"640",1,0,0,0,0,1,1,3,1,3,1,5,0,4,0,0,1,5,141653.130634686
"641",1,1,1,0,0,1,2,6,1,6,2,5,2,0,0,6,1,7,34288.8924048279
"642",1,0,0,0,0,1,1,6,2,4,2,1,0,0,0,0,1,1,22939.5679130268
"643",6,22,16,0,6,6,28,3,2,7,2,6,13,13,0,0,6,19,120320.676196948
"644",4,4,4,0,0,4,8,2,1,5,2,3,0,0,0,0,3,3,89220.179627111
"645",2,0,0,0,0,2,2,6,1,6,2,2,1,0,0,1,2,3,183486.918204967
"646",7,5,10,0,1,1,12,1,1,2,2,20,22,0,0,42,0,42,248585.770292548
"647",24,0,21,0,0,3,24,2,1,3,2,2,89,88,0,0,3,91,138255.647961974
"648",5,1,0,0,1,5,6,3,2,3,2,4,1,0,0,1,4,5,61984.6888916505
"649",1,1,0,0,0,2,2,5,2,6,2,1,2,0,0,1,2,3,73190.361159377
"650",1,0,0,0,0,1,1,3,2,6,2,1,1,0,0,1,1,2,68823.0221832274
"651",9,9,9,0,5,4,18,3,1,5,2,4,4,0,0,0,8,8,42950.8689845374
"652",1,0,0,0,0,1,1,5,1,3,2,0,0,0,0,0,0,0,256785.943788705
"653",2,3,0,1,2,2,5,2,1,2,2,5,3,0,3,3,2,8,190391.349160899
"654",1,0,0,0,0,1,1,3,1,4,2,1,8,4,0,4,1,9,272067.369039449
"655",4,3,0,0,3,4,7,4,2,4,2,0,0,0,0,0,0,0,99358.9459301026
"656",0,0,0,0,0,0,0,6,2,5,2,0,0,0,0,0,0,0,312798.730546375
"657",20,0,0,0,0,20,20,6,1,3,2,1,0,0,0,0,1,1,63060.2998963992
"658",0,0,0,0,0,0,0,4,2,4,4,0,3,1,0,2,0,3,46317.1451464315
"659",1,0,0,0,0,1,1,5,2,5,2,0,1,0,0,0,1,1,443900.036230944
"660",2,3,0,0,0,5,5,6,2,1,2,0,1,0,0,0,1,1,28911.7246475858
"661",1,14,0,0,13,2,15,6,2,3,2,0,0,0,0,0,0,0,270728.468981519
"662",3,0,0,0,0,3,3,4,2,8,2,3,2,0,0,2,3,5,131125.989128616
"663",6,19,25,0,0,0,25,2,2,5,2,1,2,0,0,2,1,3,42509.2255957599
"664",2,12,12,0,0,2,14,4,2,6,2,2,0,0,0,0,2,2,86356.3464891464
"665",8,111,117,0,0,2,119,2,2,3,2,4,10,13,0,0,1,14,193928.024477264
"666",0,5,0,0,2,3,5,1,1,1,2,7,5,0,0,9,3,12,16235.4895552277
"667",1,17,17,0,0,1,18,5,1,4,2,1,14,13,0,0,2,15,102422.963859731
"668",32,0,20,0,10,2,32,3,2,7,2,42,0,40,0,0,2,42,88067.7395579229
"669",5,7,9,0,0,3,12,3,2,6,2,3,7,0,0,7,3,10,61833.786348215
"670",1,0,0,0,0,1,1,6,2,8,2,1,0,0,0,0,1,1,125754.867426171
"671",12,61,18,38,11,6,73,1,1,2,2,13,8,0,5,3,13,21,101365.960163314
"672",0,0,0,0,0,0,0,5,2,4,2,0,33,33,0,0,0,33,27167.5296875873
"673",2,1,0,0,0,3,3,4,2,5,2,2,55,55,0,0,2,57,349904.631610825
"674",3,0,0,0,0,3,3,4,1,6,2,3,1,0,0,1,3,4,83943.2446084655
"675",0,4,0,0,4,0,4,6,2,6,2,1,0,0,0,1,0,1,42953.5349777519
"676",1,5,6,0,0,0,6,2,2,4,2,0,3,0,0,2,1,3,52956.2068808729
"677",7,4,0,0,8,3,11,4,2,8,4,2,5,0,0,6,1,7,217644.04470348
"678",1,1,0,0,0,2,2,6,1,3,2,4,0,0,0,0,4,4,398258.765610253
"679",0,6,6,0,0,0,6,6,2,3,2,1,3,2,0,2,0,4,17968.3277210851
"680",9,4,0,0,10,3,13,5,1,6,2,12,9,0,0,13,8,21,34642.3759259885
"681",1,0,0,0,0,1,1,6,1,7,2,1,0,0,0,0,1,1,121209.156083455
"682",0,0,0,0,0,0,0,4,2,4,2,9,10,16,0,0,3,19,46735.3907186901
"683",14,4,10,0,7,1,18,3,2,5,2,4,6,0,0,6,4,10,43499.8680341101
"684",12,30,40,0,0,2,42,2,2,3,2,1,10,10,0,0,1,11,132054.393452667
"685",1,0,0,0,0,1,1,6,2,6,2,2,1,0,0,1,2,3,47977.040747849
"686",0,0,0,0,0,0,0,2,2,3,2,0,4,4,0,0,0,4,41300.8298804305
"687",1,0,0,0,0,1,1,5,1,4,2,2,0,0,0,0,2,2,48486.3234630993
"688",8,5,12,0,0,1,13,2,1,4,2,2,7,8,0,0,1,9,539957.475859467
"689",2,0,0,0,1,1,2,6,2,6,2,0,1,0,0,1,0,1,35116.4044525923
"690",2,0,2,0,0,0,2,5,2,2,2,4,2,4,0,0,2,6,185939.379258251
"691",0,1,0,0,0,1,1,6,2,3,2,5,1,0,0,3,3,6,46321.6638905871
"692",0,19,17,0,0,2,19,3,2,3,2,0,21,10,0,10,1,21,44627.2027076711
"693",0,5,0,0,5,0,5,5,2,8,2,0,0,0,0,0,0,0,166687.781101073
"694",3,1,0,0,4,0,4,6,2,4,2,1,0,0,0,0,1,1,250793.700005868
"695",1,0,0,0,0,1,1,6,1,6,2,1,0,0,0,0,1,1,84729.3484580244
"696",3,117,117,0,0,3,120,3,1,5,2,13,113,123,0,0,3,126,88637.4903624909
"697",9,0,0,0,9,0,9,5,2,4,2,28,1,0,0,28,1,29,33843.2524571436
"698",1,3,0,0,0,4,4,6,2,4,2,0,0,0,0,0,0,0,41960.1339012667
"699",3,32,30,0,0,5,35,2,2,7,1,2,25,26,0,0,1,27,244971.98054511
"700",0,1,0,0,1,0,1,5,2,5,2,0,18,18,0,0,0,18,26911.8144901055
"701",1,0,0,0,0,1,1,6,1,7,2,2,1,0,0,2,1,3,401413.723577864
"702",6,8,0,0,10,4,14,2,2,6,2,8,17,0,0,0,25,25,126541.638038053
"703",3,5,0,0,5,3,8,5,2,6,2,5,0,0,0,3,2,5,68223.3678258144
"704",0,0,0,0,0,0,0,6,1,7,2,0,1,0,0,1,0,1,69322.8847381159
"705",257,0,255,0,2,0,257,2,2,3,2,5,21,20,0,3,3,26,246119.452758581
"706",1,2,0,0,2,1,3,6,1,6,2,1,4,0,0,1,4,5,34288.8924048279
"707",1,0,0,0,0,1,1,6,1,8,1,0,0,0,0,0,0,0,280812.825977046
"708",2,1,0,0,1,2,3,2,2,7,2,4,0,0,0,2,2,4,186702.931948945
"709",14,5,6,0,12,1,19,4,2,8,2,3,19,19,0,0,3,22,368976.492109176
"710",0,0,0,0,0,0,0,6,1,6,2,0,0,0,0,0,0,0,43492.7225690568
"711",0,0,0,0,0,0,0,3,2,5,2,1,0,0,0,0,1,1,109200.355451725
"712",65,0,60,0,0,5,65,6,2,8,2,5,18,22,0,0,1,23,188235.123369015
"713",5,4,0,0,9,0,9,5,2,3,2,4,0,0,0,0,4,4,103742.501785166
"714",3,0,0,0,0,3,3,3,2,7,2,3,3,0,0,0,6,6,54731.9290697472
"715",0,1,0,0,1,0,1,6,2,5,2,0,1,0,0,1,0,1,30452.2493249529
"716",3,0,0,0,1,2,3,2,1,7,2,4,0,0,0,0,4,4,539957.475859467
"717",7,7,9,0,0,5,14,3,2,6,2,4,0,0,0,0,4,4,90629.5850083942
"718",0,0,0,0,0,0,0,6,1,2,2,3,1,0,0,2,2,4,58960.496177671
"719",1,0,0,0,0,1,1,5,2,6,2,10,0,9,0,0,1,10,73190.361159377
"720",5,0,2,0,0,3,5,3,1,3,2,3,1,0,0,1,3,4,459455.153034407
"721",1,28,0,0,26,3,29,6,1,8,2,1,9,7,0,2,1,10,182293.26500579
"722",0,10,0,0,9,1,10,3,2,7,2,3,6,0,0,7,2,9,80220.4152656301
"723",1,6,0,0,4,3,7,6,2,1,2,0,9,0,0,6,3,9,103422.370208498
"724",9,5,12,0,0,2,14,5,2,5,1,2,0,2,0,0,0,2,539957.475859467
"725",2,0,0,0,0,2,2,6,1,6,2,1,2,0,0,2,1,3,158078.255690361
"726",6,14,0,12,4,4,20,1,1,1,2,5,0,0,2,3,0,5,40739.7890507648
"727",1,0,0,0,0,1,1,3,2,4,2,0,8,8,0,0,0,8,17017.8825655498
"728",0,1,0,0,0,1,1,4,2,2,2,0,0,0,0,0,0,0,30228.4747306593
"729",5,1,0,0,1,5,6,3,2,6,1,8,1,0,0,5,4,9,411294.557744566
"730",24,8,0,0,0,32,32,6,2,5,2,0,0,0,0,0,0,0,31075.2458980517
"731",10,4,0,0,14,0,14,5,2,5,3,0,0,0,0,0,0,0,133116.892628209
"732",6,0,0,0,0,6,6,2,2,3,2,7,0,5,0,0,2,7,141247.573493566
"733",0,26,25,0,0,1,26,5,2,6,2,1,5,5,0,0,1,6,97858.6016524113
"734",1,4,0,0,4,1,5,2,1,5,2,1,0,0,0,0,1,1,207548.04221965
"735",1,2,0,0,1,2,3,4,2,3,2,0,0,0,0,0,0,0,43230.0044295829
"736",0,1,0,0,0,1,1,6,1,6,2,0,0,0,0,0,0,0,176934.938691306
"737",0,0,0,0,0,0,0,6,2,4,2,3,1,0,0,4,0,4,90690.9874312746
"738",0,4,0,0,4,0,4,6,2,5,2,0,2,0,0,0,2,2,33008.1253147042
"739",53,12,62,0,0,3,65,3,2,4,2,18,17,0,0,35,0,35,156101.908653521
"740",0,2,0,0,2,0,2,2,1,7,2,0,2,0,0,2,0,2,270679.986109398
"741",0,4,0,0,3,1,4,6,2,7,2,0,1,0,0,0,1,1,107282.692689231
"742",2,2,0,0,1,3,4,6,2,5,2,1,1,0,0,1,1,2,24704.2765732928
"743",0,6,0,0,0,6,6,6,1,4,2,3,3,0,0,1,5,6,70743.8238183373
"744",3,0,0,0,0,3,3,6,1,5,3,5,1,0,0,1,5,6,327220.137121136
"745",1,4,0,0,3,2,5,2,2,4,2,1,0,0,0,0,1,1,110738.165994343
"746",13,1,0,0,14,0,14,4,2,6,2,0,4,3,0,0,1,4,491334.143038796
"747",1,0,0,0,0,1,1,4,2,5,2,1,0,0,0,0,1,1,38162.0087540553
"748",5,1,0,0,2,4,6,6,2,6,2,2,2,0,0,3,1,4,47977.040747849
"749",1,4,1,0,3,1,5,5,1,3,2,1,11,4,0,7,1,12,9790.39591501165
"750",1,0,0,0,0,1,1,4,2,4,2,1,2,0,0,2,1,3,19902.2111926863
"751",0,0,0,0,0,0,0,6,2,4,2,8,43,0,0,51,0,51,26077.1888090843
"752",5,30,29,0,6,0,35,2,1,3,2,3,11,0,0,14,0,14,53403.7998168567
"753",1,0,0,0,0,1,1,1,1,1,1,0,0,0,0,0,0,0,322789.324395541
"754",1,0,0,0,1,0,1,5,1,4,2,2,5,0,0,3,4,7,41620.127393076
"755",0,0,0,0,0,0,0,6,2,4,2,0,2,0,0,2,0,2,45149.2141961116
"756",0,11,11,0,0,0,11,5,2,3,2,4,0,0,0,0,4,4,34790.1968932617
"757",1,6,0,0,6,1,7,6,2,4,2,11,36,0,0,47,0,47,80008.4741769863
"758",10,10,20,0,0,0,20,5,1,3,2,0,0,0,0,0,0,0,284920.080623522
"759",7,6,6,0,7,0,13,4,2,6,2,1,10,5,0,6,0,11,307587.825781024
"760",1,0,0,0,0,1,1,4,2,6,2,1,0,0,0,1,0,1,44788.1253092251
"761",4,0,0,0,0,4,4,6,2,2,2,2,0,0,0,0,2,2,259100.528501937
"762",4,2,0,0,0,6,6,3,1,4,2,7,1,0,0,0,8,8,115552.042511185
"763",3,0,0,0,0,3,3,3,2,6,2,3,0,0,0,0,3,3,85139.2733076072
"764",1,0,0,0,0,1,1,6,1,6,2,1,0,0,0,0,1,1,137600.422599631
"765",6,57,59,0,2,2,63,1,2,5,2,3,2,0,1,2,2,5,539957.475859467
"766",6,8,13,0,0,1,14,2,1,4,2,3,0,0,3,0,0,3,93126.0778940556
"767",0,1,0,0,1,0,1,2,2,4,1,0,2,0,0,0,2,2,162822.992334206
"768",0,311,0,0,304,7,311,3,2,4,2,11,12,0,0,15,8,23,97678.663068147
"769",2,2,0,0,3,1,4,6,2,6,2,64,2,0,0,2,64,66,77801.9056014036
"770",3,1,0,0,0,4,4,6,1,5,1,1,0,0,0,0,1,1,47082.3127138752
"771",1,1,1,0,1,0,2,6,2,8,2,3,1,0,0,4,0,4,158165.940778641
"772",0,1,0,0,1,0,1,6,2,8,2,0,2,0,0,2,0,2,98296.2330519772
"773",2,0,0,0,0,2,2,6,2,3,2,1,1,0,0,1,1,2,437134.423533837
"774",2,1,0,0,1,2,3,3,1,6,2,0,7,0,0,7,0,7,96575.8118501435
"775",0,5,0,0,0,5,5,6,2,5,2,0,2,0,0,0,2,2,61575.960287638
"776",1,15,10,0,5,1,16,3,2,3,1,13,6,0,0,4,15,19,523509.189469128
"777",0,22,0,0,21,1,22,6,2,3,2,0,0,0,0,0,0,0,16879.8120898868
"778",6,6,12,0,0,0,12,5,1,2,1,1,6,6,0,0,1,7,139435.916643402
"779",0,3,0,0,3,0,3,6,2,2,2,0,0,0,0,0,0,0,385788.885185364
"780",86,11,21,75,0,1,97,4,2,7,2,4,0,3,0,0,1,4,71807.3868004127
"781",5,15,16,0,1,3,20,3,1,3,1,6,4,0,0,4,6,10,313105.592489111
"782",6,27,24,0,7,2,33,2,1,4,2,3,1,0,0,3,1,4,147765.762188657
"783",1,0,0,0,0,1,1,4,1,2,2,0,0,0,0,0,0,0,13898.6187033405
"784",1,0,0,0,0,1,1,6,1,6,2,0,2,0,0,2,0,2,54400.9857615263
"785",0,1,0,0,1,0,1,5,2,3,2,9,2,0,0,2,9,11,23899.6537037546
"786",6,0,6,0,0,0,6,6,1,6,2,1,0,0,0,0,1,1,33877.4079761637
"787",11,0,0,0,0,11,11,2,2,4,2,4,8,0,0,8,4,12,102308.247800165
"788",1,0,0,0,0,1,1,5,2,4,2,1,2,0,0,1,2,3,44914.7543541442
"789",96,0,94,0,0,2,96,5,2,3,1,1,0,0,0,0,1,1,78252.9671858444
"790",0,4,0,0,4,0,4,6,1,3,2,1,0,0,0,1,0,1,71206.1246740552
"791",2,0,0,0,1,1,2,4,1,8,2,1,6,0,0,6,1,7,355256.20701439
"792",9,2,0,0,11,0,11,2,1,5,1,3,0,0,0,0,3,3,66598.4181008787
"793",0,8,5,0,3,0,8,4,2,3,2,0,1,0,0,0,1,1,18233.0053301003
"794",1,1,0,0,1,1,2,5,1,6,2,0,3,0,0,3,0,3,27750.2326029617
"795",1,1,0,0,2,0,2,2,2,4,1,5,0,0,0,5,0,5,113397.584625921
"796",8,15,0,0,18,5,23,3,1,6,2,5,0,0,0,0,5,5,40486.9102926679
"797",0,3,0,0,2,1,3,4,2,4,2,0,1,0,0,1,0,1,91431.2114980341
"798",3,3,3,0,0,3,6,3,2,8,2,4,9,9,0,0,4,13,170320.338759565
"799",5,0,0,0,2,3,5,3,2,6,2,4,8,8,0,0,4,12,175741.283167579
"800",2,2,0,0,3,1,4,6,1,8,2,1,0,0,0,0,1,1,289217.079307171
"801",0,0,0,0,0,0,0,6,2,4,2,0,4,0,0,4,0,4,73952.2471659844
"802",28,0,26,0,0,2,28,4,1,8,2,3,4,0,0,4,3,7,355256.20701439
"803",6,0,0,0,5,1,6,5,2,7,2,1,0,0,0,0,1,1,287002.8730536
"804",2,0,0,0,0,2,2,6,1,4,2,1,1,0,0,1,1,2,60935.5393742463
"805",4,2,0,0,0,6,6,4,2,6,2,1,3,0,0,3,1,4,81124.9062312807
"806",1,1,0,0,0,2,2,6,2,6,2,0,0,0,0,0,0,0,64456.4913085239
"807",2,2,0,0,3,1,4,5,2,3,2,0,5,0,0,5,0,5,81011.30031186
"808",0,1,0,0,0,1,1,5,2,2,2,0,7,0,0,3,4,7,48015.7755118268
"809",3,0,0,0,0,3,3,3,1,6,2,4,1,0,0,1,4,5,39083.0058498444
"810",3,9,4,0,3,5,12,1,2,2,2,1,3,2,0,0,2,4,190653.59727447
"811",12,10,0,0,20,2,22,6,2,7,2,2,0,0,0,0,2,2,110810.583732146
"812",15,15,30,0,0,0,30,3,2,5,2,5,35,40,0,0,0,40,57126.5153911571
"813",5,0,0,0,1,4,5,4,1,7,2,4,1,0,0,1,4,5,77026.2982433083
"814",1,7,0,0,7,1,8,1,2,6,1,1,0,0,0,0,1,1,105606.779910804
"815",14,15,23,0,5,1,29,5,2,3,2,16,10,23,0,1,2,26,57571.6744605846
"816",2,1,1,0,1,1,3,4,2,2,2,1,0,0,0,0,1,1,61950.9742651899
"817",8,15,19,0,0,4,23,4,1,6,2,5,0,0,0,5,0,5,217543.932078374
"818",0,3,0,0,0,3,3,6,2,2,2,3,2,0,0,5,0,5,33896.4442262963
"819",3,0,0,0,0,3,3,3,1,4,2,3,8,6,0,2,3,11,44228.6725311385
"820",3,13,12,0,0,4,16,3,2,3,2,2,9,9,0,0,2,11,62469.0798818208
"821",92,73,117,0,24,24,165,5,1,3,2,59,10,43,0,20,6,69,81953.1776920815
"822",6,0,0,0,4,2,6,6,1,5,2,1,0,0,0,0,1,1,59751.0904559664
"823",0,2,0,0,1,1,2,6,2,6,2,1,5,0,0,5,1,6,136057.993123915
"824",4,10,0,0,9,5,14,2,2,3,2,1,0,0,0,0,1,1,41444.2003764802
"825",0,0,0,0,0,0,0,6,1,3,2,1,3,0,0,3,1,4,319024.694075961
"826",10,7,16,0,0,1,17,5,1,6,2,163,0,163,0,0,0,163,539957.475859467
"827",4,15,0,0,15,4,19,5,1,7,2,6,7,0,0,10,3,13,166180.479050218
"828",2,11,0,0,11,2,13,3,1,8,2,2,0,0,0,0,2,2,341534.285677025
"829",3,0,0,0,0,3,3,3,1,6,2,1,1,0,0,0,2,2,40256.9388020289
"830",1,0,0,0,0,1,1,5,1,6,2,2,2,0,0,2,2,4,66572.4052154278
"831",0,110,110,0,0,0,110,4,1,7,4,0,13,5,0,7,1,13,130038.378853467
"832",2,0,0,0,0,2,2,4,2,7,2,1,0,0,0,0,1,1,97386.0317779756
"833",0,0,0,0,0,0,0,6,1,2,2,0,0,0,0,0,0,0,16711.5229352525
"834",4,37,38,0,0,3,41,4,2,5,2,4,32,34,0,0,2,36,36096.7729036249
"835",3,0,0,0,2,1,3,6,2,6,2,0,1,0,0,0,1,1,10388.5065084507
"836",2,1,0,0,1,2,3,6,2,5,2,1,11,0,0,11,1,12,26396.522173803
"837",1,2,0,0,2,1,3,6,2,3,2,0,0,0,0,0,0,0,9200.19247324491
"838",2,19,1,0,20,0,21,6,1,1,2,0,3,0,0,3,0,3,20978.5048546458
"839",0,0,0,0,0,0,0,4,2,3,2,0,16,0,0,10,6,16,57253.3211950126
"840",1,1,0,0,2,0,2,4,1,5,1,0,8,0,0,8,0,8,30626.1951173753
"841",1,0,0,0,0,1,1,2,1,3,3,7,0,5,0,0,2,7,539957.475859467
"842",0,2,1,0,0,1,2,5,2,1,2,0,0,0,0,0,0,0,7845.28815532985
"843",1,3,0,0,3,1,4,4,1,8,2,2,2,0,0,3,1,4,176876.11420599
"844",0,8,0,0,3,5,8,1,1,3,2,0,4,0,0,0,4,4,94506.4580360766
"845",4,43,46,0,0,1,47,2,2,4,2,2,2,0,0,0,4,4,105103.369497978
"846",1,1,0,0,1,1,2,2,2,7,2,6,0,0,0,6,0,6,80722.6803693233
"847",1,0,0,0,0,1,1,2,1,8,2,1,3,0,0,3,1,4,224540.780924447
"848",3,2,0,0,2,3,5,1,2,3,2,5,7,0,0,0,12,12,16405.6920844294
"849",2,5,0,0,5,2,7,3,2,6,1,2,0,0,0,0,2,2,143238.928725053
"850",1,4,0,0,4,1,5,6,1,6,2,2,0,0,0,1,1,2,28381.1755292171
"851",2,2,0,0,0,4,4,4,2,5,2,2,2,2,0,0,2,4,11644.6189485727
"852",1,1,0,0,1,1,2,3,1,5,2,1,1,0,0,1,1,2,27132.4992976869
"853",2,3,5,0,0,0,5,5,1,6,2,2,4,0,0,4,2,6,29735.5584757942
"854",1,1,0,0,1,1,2,6,2,5,2,1,0,0,0,0,1,1,10780.3939148611
"855",1,3,0,0,2,2,4,6,1,6,2,0,2,0,0,0,2,2,28381.1755292171
"856",1,0,0,0,0,1,1,5,2,4,2,6,6,0,0,0,12,12,37856.5020386448
"857",3,0,0,0,0,3,3,2,2,6,2,4,0,0,0,1,3,4,73878.3701243058
"858",11,18,21,0,7,1,29,4,2,7,2,1,6,3,0,3,1,7,61833.020332365
"859",1,4,0,0,0,5,5,2,2,6,2,4,1,0,0,0,5,5,176137.783096412
"860",0,0,0,0,0,0,0,5,2,4,2,0,0,0,0,0,0,0,22496.4687045558
"861",5,1,0,0,0,6,6,6,2,5,2,5,0,0,0,0,5,5,136117.222743684
"862",0,0,0,0,0,0,0,6,2,2,5,2,1,0,0,0,3,3,46478.5985314329
"863",7,0,2,0,2,3,7,2,2,5,1,0,0,0,0,0,0,0,56442.6817893244
"864",0,5,4,0,1,0,5,5,2,5,2,0,0,0,0,0,0,0,42248.1022503082
"865",1,0,0,0,0,1,1,6,1,6,2,1,5,0,0,4,2,6,11485.5016798101
"866",0,12,0,0,11,1,12,5,1,3,4,0,0,0,0,0,0,0,10298.9127962732
"867",2,1,0,0,0,3,3,5,2,7,2,3,2,0,0,2,3,5,27600.0698607087
"868",0,15,15,0,0,0,15,3,1,5,2,0,2,0,0,2,0,2,320511.546332548
"869",0,1,0,0,0,1,1,5,2,6,2,3,1,0,0,0,4,4,42875.9459696007
"870",2,0,0,0,0,2,2,2,2,5,1,8,4,0,0,9,3,12,110975.431051179
"871",1,0,0,0,0,1,1,5,1,5,2,1,1,1,0,0,1,2,57556.1143874179
"872",2,3,0,0,4,1,5,5,2,1,5,0,0,0,0,0,0,0,41756.4953751705
"873",1,0,0,0,0,1,1,6,2,5,2,0,1,0,0,0,1,1,108513.816509167
"874",1,7,0,0,4,4,8,5,1,8,2,5,0,0,0,5,0,5,48559.119147297
"875",32,0,30,0,0,2,32,5,2,4,3,0,0,0,0,0,0,0,171846.307564775
"876",3,10,10,0,0,3,13,3,2,5,2,3,0,0,0,0,3,3,68257.4764973053
"877",2,6,0,0,6,2,8,1,2,2,1,0,0,0,0,0,0,0,74525.8627981652
"878",2,2,0,0,3,1,4,6,1,4,2,1,1,0,0,1,1,2,20659.0551536729
"879",0,0,0,0,0,0,0,3,1,8,2,2,2,0,0,4,0,4,47217.3380506852
"880",2,5,0,0,5,2,7,5,2,6,4,2,3,0,0,3,2,5,72350.7645144502
"881",2,2,0,0,0,4,4,3,1,8,2,1,0,0,0,0,1,1,29531.8862890051
"882",0,2,0,0,0,2,2,5,1,1,2,1,3,0,0,4,0,4,5097.60500385038
"883",0,1,0,0,1,0,1,3,2,6,2,0,5,0,0,5,0,5,25336.1550453851
"884",1,27,28,0,0,0,28,5,2,5,2,1,1,0,0,2,0,2,12729.3712393383
"885",21,0,19,0,2,0,21,6,2,6,2,2,0,0,0,0,2,2,44470.8479291959
"886",2,3,0,0,5,0,5,6,1,6,2,0,5,0,0,5,0,5,11830.4907255888
"887",0,1,0,0,0,1,1,5,1,3,2,1,1,0,0,1,1,2,18712.5090377215
"888",2,0,0,0,0,2,2,6,2,7,5,1,0,0,0,0,1,1,165469.271838731
"889",0,9,1,0,8,0,9,5,2,5,2,3,11,11,0,3,0,14,7950.65579598416
"890",4,15,15,0,0,4,19,2,2,4,4,9,15,20,0,0,4,24,146602.448605291
"891",0,1,0,0,0,1,1,4,2,3,2,0,2,0,0,0,2,2,40111.5080460594
"892",1,0,0,0,0,1,1,5,2,3,2,1,0,0,0,0,1,1,9930.12132003037
"893",3,0,0,0,0,3,3,5,1,3,1,4,1,0,0,2,3,5,42191.6598751008
"894",1,8,6,0,1,2,9,2,2,8,4,3,9,10,0,0,2,12,408637.682673498
"895",4,10,10,0,0,4,14,2,2,2,1,62,22,80,0,0,4,84,74646.5313626234
"896",1,2,2,0,0,1,3,2,2,1,2,1,5,0,0,1,5,6,21130.8782929772
"897",3,0,0,0,2,1,3,3,1,6,2,2,0,0,0,1,1,2,93061.6360752944
"898",4,0,0,0,0,4,4,6,2,3,2,1,0,0,0,0,1,1,9349.38565604938
"899",13,6,0,0,16,3,19,6,2,4,2,1,2,0,0,2,1,3,62907.8145005338
"900",4,2,0,0,2,4,6,6,1,7,2,1,1,0,0,1,1,2,55705.8441582946
"901",0,0,0,0,0,0,0,5,2,4,2,0,3,0,0,3,0,3,37448.4650473716
"902",1,6,0,0,0,7,7,6,2,4,2,0,0,0,0,0,0,0,17494.6314621706
"903",1,8,7,0,0,2,9,5,1,8,2,1,11,10,0,0,2,12,79817.8423304318
"904",0,1,0,0,1,0,1,4,2,6,2,0,2,0,0,2,0,2,36627.5920825714
"905",1,0,0,0,0,1,1,5,1,6,2,1,4,0,0,4,1,5,56258.5015643651
"906",0,3,0,0,2,1,3,2,2,4,4,1,1,0,0,0,2,2,80052.3819465476
"907",0,5,0,0,4,1,5,5,2,1,3,0,0,0,0,0,0,0,137698.760153934
"908",0,3,2,0,0,1,3,3,1,6,2,1,0,0,0,0,1,1,20567.6785058183
"909",2,0,0,0,0,2,2,1,2,1,2,2,4,0,0,4,2,6,52124.6809858742
"910",4,0,0,0,0,4,4,1,1,8,2,3,4,0,0,1,6,7,157994.781134069
"911",3,13,9,0,7,0,16,4,2,3,1,0,10,10,0,0,0,10,36025.3906810116
"912",1,4,0,0,5,0,5,3,2,5,2,1,2,0,0,3,0,3,24106.3320300548
"913",1,1,0,0,1,1,2,6,1,5,2,1,1,0,0,0,2,2,20257.4898966696
"914",0,6,0,0,5,1,6,5,2,6,2,0,3,0,0,3,0,3,362526.372550443
"915",0,9,0,0,8,1,9,3,2,5,4,0,1,0,0,1,0,1,67314.7086192582
"916",1,5,0,0,5,1,6,6,2,6,2,10,0,0,0,0,10,10,25875.5377981095
"917",35,0,34,0,0,1,35,4,2,6,2,3,15,16,0,0,2,18,68376.3102412689
"918",5,20,21,0,0,4,25,4,2,3,1,0,3,3,0,0,0,3,137575.275099352
"919",0,0,0,0,0,0,0,4,1,7,2,0,1,0,0,0,1,1,25300.8986767422
"920",0,0,0,0,0,0,0,5,2,8,2,0,0,0,0,0,0,0,37228.4029164277
"921",1,0,0,0,0,1,1,2,2,5,2,1,0,0,0,0,1,1,22023.32617674
"922",0,2,0,0,2,0,2,3,1,7,2,0,0,0,0,0,0,0,141415.530237852
"923",0,2,0,0,1,1,2,6,2,7,2,0,1,0,0,0,1,1,31737.5018490516
"924",1,0,0,0,0,1,1,1,2,1,1,4,0,0,0,0,4,4,180713.19307948
"925",0,4,0,0,4,0,4,4,1,1,2,0,0,0,0,0,0,0,13705.5375344028
"926",1,9,0,0,5,5,10,6,2,3,2,0,0,0,0,0,0,0,16349.9677735483
"927",0,0,0,0,0,0,0,5,1,4,1,1,4,0,0,5,0,5,253065.942999589
"928",0,0,0,0,0,0,0,4,1,8,2,1,1,0,0,1,1,2,19173.3569362944
"929",11,0,0,9,0,2,11,4,2,4,2,3,3,0,0,4,2,6,58846.8077287873
"930",1,1,0,0,1,1,2,4,1,6,2,0,8,0,0,8,0,8,60419.5732059099
"931",4,0,0,0,2,2,4,2,1,6,2,22,0,20,0,0,2,22,49571.9078484901
"932",3,3,0,0,5,1,6,6,2,5,2,3,2,0,0,4,1,5,100569.208167984
"933",0,9,0,0,9,0,9,4,1,4,4,0,37,0,0,37,0,37,57739.2074900821
"934",10,6,0,0,1,15,16,6,2,6,2,1,1,0,0,1,1,2,65442.8476914428
"935",0,0,0,0,0,0,0,5,2,4,2,0,2,0,0,0,2,2,25672.8571777335
"936",5,12,9,0,0,8,17,4,1,7,2,2,171,171,0,0,2,173,153861.711922184
"937",5,4,0,0,8,1,9,6,2,7,2,2,2,0,0,3,1,4,23705.2490071244
"938",1,1,0,0,1,1,2,4,2,4,2,1,2,2,0,0,1,3,33046.7896384235
"939",1,4,0,0,0,5,5,4,2,1,5,7,0,0,0,7,0,7,90555.212489535
"940",0,15,13,0,2,0,15,4,2,4,2,7,11,12,0,5,1,18,15723.4401914088
"941",1,0,0,0,0,1,1,4,1,8,2,3,5,5,0,0,3,8,46028.7730820396
"942",7,0,0,0,6,1,7,5,2,8,2,1,1,1,0,1,0,2,29991.1035414499
"943",1,0,0,0,0,1,1,4,1,6,2,2,0,1,0,0,1,2,121679.580061865
"944",1,1,0,0,0,2,2,6,2,6,2,2,5,0,0,6,1,7,181374.647502998
"945",0,3,3,0,0,0,3,6,1,3,2,0,0,0,0,0,0,0,5356.68046725032
"946",0,0,0,0,0,0,0,6,2,3,4,0,0,0,0,0,0,0,203664.080190409
"947",0,0,0,0,0,0,0,6,2,3,2,0,2,0,0,0,2,2,19328.7349935836
"948",6,4,0,0,7,3,10,1,2,4,2,5,8,0,0,12,1,13,74943.8095966781
"949",0,0,0,0,0,0,0,5,2,7,3,0,0,0,0,0,0,0,61101.6505509751
"950",0,0,0,0,0,0,0,6,2,8,2,0,3,0,0,3,0,3,87688.2759937917
"951",1,0,0,0,0,1,1,5,1,6,2,1,0,0,0,0,1,1,35034.1484247796
"952",3,5,5,0,1,2,8,4,2,8,2,8,0,0,0,8,0,8,68228.2436587446
"953",14,6,0,0,19,1,20,2,1,3,1,3,0,0,0,2,1,3,38829.6013801732
"954",0,0,0,0,0,0,0,6,1,3,1,0,0,0,0,0,0,0,33459.8556612312
"955",5,1,0,0,1,5,6,2,2,5,2,5,1,0,0,5,1,6,34867.5371564501
"956",1,5,0,0,5,1,6,2,2,7,2,1,2,0,0,0,3,3,88686.9598359732
"957",0,0,0,0,0,0,0,5,1,4,2,1,2,0,0,1,2,3,10320.2740743623
"958",2,3,0,0,3,2,5,3,2,8,4,2,0,0,0,0,2,2,103255.141609503
"959",0,2,0,0,2,0,2,5,2,5,2,0,1,0,0,1,0,1,31231.9091044205
"960",6,0,0,0,4,2,6,3,2,4,2,4,2,0,0,4,2,6,109531.523579937
"961",23,2,0,0,2,23,25,2,2,1,2,0,1,0,0,0,1,1,228319.446276893
"962",0,4,0,0,3,1,4,6,2,3,2,1,3,0,0,3,1,4,9103.50800545958
"963",0,10,8,0,0,2,10,5,1,8,4,1,0,0,0,0,1,1,62237.2700199334
"964",0,10,0,0,10,0,10,6,1,4,2,1,0,0,0,1,0,1,37915.0515916746
"965",5,3,0,0,5,3,8,5,1,8,2,1,11,10,0,0,2,12,128173.008607647
"966",4,5,0,0,3,6,9,6,2,7,2,1,0,0,0,0,1,1,110810.583732146
"967",0,0,0,0,0,0,0,6,2,3,2,0,0,0,0,0,0,0,40153.330779516
"968",1,2,0,0,2,1,3,6,2,6,2,1,0,0,0,0,1,1,27743.1828957057
"969",2,4,1,0,3,2,6,2,1,6,2,0,3,0,0,3,0,3,31097.4759771735
"970",0,2,0,0,2,0,2,5,1,4,2,1,2,0,0,0,3,3,17530.4710672471
"971",2,2,0,0,2,2,4,5,2,1,2,2,4,4,0,0,2,6,11568.4500945843
"972",1,1,0,0,1,1,2,2,1,7,2,2,6,0,0,8,0,8,145262.346550702
"973",1,2,0,0,2,1,3,5,2,7,2,1,1,0,0,2,0,2,53138.205456324
"974",1,0,0,0,0,1,1,6,2,7,2,1,1,0,0,1,1,2,93396.9504961205
"975",2,8,0,0,8,2,10,4,2,7,2,2,3,1,0,2,2,5,24717.7249455113
"976",4,15,0,19,0,0,19,3,2,4,2,1,1,0,0,0,2,2,11897.847797365
"977",23,60,75,0,0,8,83,2,1,6,3,21,14,30,0,5,0,35,539957.475859467
"978",9,0,0,0,4,5,9,5,2,4,2,1,0,0,0,0,1,1,66202.4876415945
"979",1,0,0,0,0,1,1,5,2,2,2,2,1,0,0,2,1,3,43717.5978766899
"980",1,7,0,0,6,2,8,6,2,3,2,1,1,0,0,0,2,2,27513.322045329
"981",2,4,0,0,0,6,6,6,1,6,2,1,10,0,0,10,1,11,17828.199769004
"982",7,0,0,0,0,7,7,3,1,5,2,4,2,0,0,2,4,6,23370.253022066
"983",12,12,20,0,0,4,24,2,2,3,1,44,39,32,0,44,7,83,115436.636033449
"984",2,1,0,0,2,1,3,6,2,3,2,0,0,0,0,0,0,0,16349.9677735483
"985",0,1,0,0,0,1,1,5,1,5,4,4,0,0,0,0,4,4,51021.0555268865
"986",2,2,0,0,2,2,4,4,2,4,2,2,0,0,0,0,2,2,44666.3898788188
"987",1,0,0,0,0,1,1,5,1,4,2,1,0,0,0,0,1,1,67312.7633083563
"988",2,0,0,0,0,2,2,5,2,7,2,1,12,0,0,12,1,13,34919.7315929269
"989",1,0,0,0,0,1,1,4,2,4,2,2,1,0,0,0,3,3,37164.9006365621
"990",1,1,0,0,0,2,2,6,2,5,2,1,0,0,0,0,1,1,17346.4546154757
"991",2,0,0,0,1,1,2,3,1,5,2,0,10,1,0,9,0,10,326460.938126776
"992",0,0,0,0,0,0,0,6,2,5,2,0,3,0,0,3,0,3,21963.3627522113
"993",1,2,2,0,0,1,3,3,1,8,4,1,2,0,0,2,1,3,201504.241085173
"994",2,3,0,0,4,1,5,4,1,5,2,1,11,11,0,0,1,12,44511.8637933052
"995",3,1,0,0,3,1,4,5,2,3,2,0,2,0,0,0,2,2,15110.9072962312
"996",0,0,0,0,0,0,0,5,2,5,2,0,0,0,0,0,0,0,79792.2598769131
"997",1,22,0,0,21,2,23,3,1,3,2,1,4,0,0,3,2,5,36953.473070903
"998",0,0,0,0,0,0,0,3,1,6,4,0,5,1,0,4,0,5,90741.2086389686
"999",1,2,2,0,0,1,3,2,1,2,1,1,1,0,0,0,2,2,149256.9525852
"1000",2,0,0,0,0,2,2,2,1,5,1,0,2,0,0,0,2,2,539957.475859467
"1001",0,1,0,0,1,0,1,5,1,1,3,0,2,0,0,2,0,2,32009.3640281586
"1002",0,0,0,0,0,0,0,5,2,3,3,0,0,0,0,0,0,0,60966.7231825417
"1003",2,11,10,0,3,0,13,2,2,4,2,0,0,0,0,0,0,0,6207.603884723
"1004",2,0,0,0,0,2,2,2,2,5,2,1,0,0,0,0,1,1,60650.2082018757
"1005",1,0,0,0,0,1,1,6,2,3,1,0,0,0,0,0,0,0,26963.4609743857
"1006",1,7,0,0,7,1,8,6,2,4,1,0,1,0,0,1,0,1,44853.8168588247
"1007",3,0,0,0,0,3,3,6,2,3,3,2,0,0,0,0,2,2,523487.990463809
"1008",1,1,0,0,1,1,2,5,2,3,1,3,4,0,0,0,7,7,25657.5443318586
"1009",219,13,210,0,0,22,232,5,2,6,3,46,0,0,0,37,9,46,82172.4156069524
"1010",6,130,135,0,0,1,136,1,1,3,2,1,0,0,0,0,1,1,417244.189951791
"1011",18,2,0,0,20,0,20,4,1,6,2,2,2,4,0,0,0,4,54509.5015682402
"1012",1,1,0,0,1,1,2,6,2,4,3,1,1,0,0,1,1,2,61419.9234142431
"1013",0,5,0,0,0,5,5,5,2,4,3,0,4,4,0,0,0,4,300689.558738328
"1014",0,0,0,0,0,0,0,5,1,1,2,0,1,0,0,0,1,1,61037.7829990338
"1015",5,42,0,0,42,5,47,4,2,1,3,4,3,0,0,3,4,7,34395.0779327647
"1016",0,0,0,0,0,0,0,3,2,6,3,2,6,2,0,0,6,8,150771.13316377
"1017",0,0,0,0,0,0,0,5,1,2,2,0,0,0,0,0,0,0,94574.8189105696
"1018",0,2,0,0,1,1,2,5,1,2,2,1,1,0,0,0,2,2,809.936213789201
"1019",0,0,0,0,0,0,0,6,2,4,2,0,0,0,0,0,0,0,14572.6985524332
"1020",5,0,0,0,0,5,5,2,2,5,3,5,0,0,0,0,5,5,26957.5235574616
"1021",2,1,0,0,0,3,3,3,2,7,3,0,3,0,0,0,3,3,186853.393387479
"1022",0,0,0,0,0,0,0,3,2,3,2,3,0,0,0,0,3,3,240709.952741818
"1023",3,2,0,0,1,4,5,2,1,5,1,6,2,0,0,3,5,8,3034.74264483313
"1024",1,16,15,0,0,2,17,4,1,6,2,0,16,15,0,0,1,16,98149.4031914427
"1025",18,10,20,0,5,3,28,3,2,6,3,2,33,33,0,0,2,35,51645.9831524552
"1026",1,0,0,0,0,1,1,2,2,6,2,1,0,0,0,0,1,1,41254.2386456717
"1027",0,0,0,0,0,0,0,5,1,3,2,0,9,9,0,0,0,9,34349.6343871761
"1028",21,25,45,0,0,1,46,5,1,4,3,18,43,59,0,0,2,61,21880.2157560131
"1029",0,0,0,0,0,0,0,6,2,4,3,0,0,0,0,0,0,0,123184.901985787
"1030",10,12,0,0,16,6,22,5,2,1,3,3,3,0,0,0,6,6,13713.4201959422
"1031",0,4,1,0,3,0,4,4,1,7,2,0,0,0,0,0,0,0,37668.9653744434
"1032",1,0,0,0,0,1,1,5,2,4,3,1,0,0,0,0,1,1,70029.2596876515
"1033",2,1,0,0,3,0,3,3,2,6,5,1,2,0,0,3,0,3,43942.6680822609
"1034",0,0,0,0,0,0,0,1,2,5,3,2,0,0,0,0,2,2,539957.475859467
"1035",13,22,24,0,11,0,35,4,1,5,3,80,104,180,0,4,0,184,180277.54573221
"1036",50,0,0,0,50,0,50,4,2,4,2,1,16,0,0,15,2,17,5410.95015491737
"1037",6,2,0,0,4,4,8,5,1,2,2,2,4,0,0,4,2,6,109021.705930884
"1038",1,1,0,0,0,2,2,6,2,2,3,0,0,0,0,0,0,0,53737.7271357756
"1039",3,59,0,0,62,0,62,5,2,2,3,0,0,0,0,0,0,0,36381.1249412392
"1040",500,1000,0,0,1500,0,1500,6,2,4,3,0,1,0,0,0,1,1,134391.618256823
"1041",6,0,0,0,0,6,6,5,2,6,3,0,10,0,0,10,0,10,66776.6223892489
"1042",4,15,19,0,0,0,19,1,2,3,4,1,3,0,0,4,0,4,13060.9804442572
"1043",4,0,1,0,2,1,4,4,1,3,3,5,100,104,0,0,1,105,311986.373184282
"1044",10,7,17,0,0,0,17,5,2,5,3,4,1,2,0,0,3,5,32287.6196399244
"1045",50,0,0,0,0,50,50,5,2,6,3,49,35,0,0,35,49,84,175506.788061692
"1046",2,0,0,0,0,2,2,2,2,2,1,73,100,170,0,0,3,173,71824.9796715265
"1047",0,0,0,0,0,0,0,4,2,7,3,0,0,0,0,0,0,0,87210.2436519047
"1048",0,42,40,0,0,2,42,5,1,8,3,0,32,30,0,0,2,32,186401.976199099
"1049",0,0,0,0,0,0,0,5,2,5,2,0,0,0,0,0,0,0,7729.67913731476
"1050",0,0,0,0,0,0,0,6,1,5,2,0,1,0,0,0,1,1,26857.8675944551
"1051",1,1,0,0,0,2,2,4,1,2,2,0,2,0,0,0,2,2,319718.17277289
"1052",4,0,0,0,0,4,4,1,2,1,3,0,0,0,0,0,0,0,245374.564911643
"1053",4,18,18,0,0,4,22,3,2,7,2,4,0,0,0,0,4,4,43986.5922296176
"1054",2,19,17,0,0,4,21,4,2,4,2,2,3,3,0,0,2,5,20884.7606294034
"1055",2,1,0,0,3,0,3,6,1,3,2,1,13,13,0,0,1,14,29057.4846498807
"1056",3,0,0,0,0,3,3,5,2,5,3,300,25,325,0,0,0,325,142817.295254384
"1057",0,9,7,0,0,2,9,4,1,5,3,0,0,0,0,0,0,0,36997.4025829937
"1058",5,11,0,0,13,3,16,6,1,4,2,2,4,0,0,4,2,6,115726.764399052
"1059",29,12,0,0,36,5,41,3,2,4,2,4,1,0,0,1,4,5,18449.9682583118
"1060",1,0,0,0,1,0,1,5,2,4,3,2,0,0,0,0,2,2,64381.2569765787
"1061",0,0,0,0,0,0,0,6,2,1,3,1,0,0,0,0,1,1,28708.1388128999
"1062",0,0,0,0,0,0,0,4,2,1,2,0,1,0,0,0,1,1,8872.69576475534
"1063",0,0,0,0,0,0,0,6,2,3,2,0,11,11,0,0,0,11,6153.73898122931
"1064",0,3,0,0,0,3,3,5,2,8,2,0,5,0,0,0,5,5,76807.8751389456
"1065",29,29,19,17,21,1,58,1,1,2,2,61,23,26,26,8,24,84,48106.3603221107
"1066",3,0,0,0,0,3,3,2,2,3,3,1,3,0,0,0,4,4,102843.323710462
"1067",0,0,0,0,0,0,0,5,1,6,3,0,0,0,0,0,0,0,195370.756318072
"1068",0,0,0,0,0,0,0,5,1,6,3,0,2,0,0,2,0,2,287489.669981184
"1069",2,10,11,0,0,1,12,1,1,1,2,4,5,0,0,5,4,9,13706.99390837
"1070",7,7,11,0,0,3,14,6,1,8,2,8,3,0,0,3,8,11,56896.4021451405
"1071",6,2,7,0,0,1,8,4,2,4,3,0,3,0,0,0,3,3,24410.6799652171
"1072",2,0,0,0,0,2,2,1,2,3,1,0,0,0,0,0,0,0,454605.888393325
"1073",2,0,0,0,0,2,2,6,1,1,1,4,5,0,0,5,4,9,23758.6227280887
"1074",8,0,0,0,8,0,8,3,1,7,2,7,0,0,0,0,7,7,249297.074342354
"1075",12,4,6,5,0,5,16,5,1,6,1,9,5,8,0,5,1,14,56767.0138564664
"1076",18,15,5,0,23,5,33,4,1,3,1,1,0,0,0,0,1,1,96927.6393442255
"1077",1,0,0,0,0,1,1,2,2,5,1,1,2,0,0,2,1,3,58350.2727512873
"1078",10,0,8,0,0,2,10,1,2,4,1,6,9,0,12,0,3,15,539957.475859467
"1079",1,50,0,0,50,1,51,6,2,6,1,4,0,0,0,0,4,4,171389.342380196
"1080",1,2,0,0,2,1,3,5,1,6,1,1,0,0,0,0,1,1,33222.8163542725
"1081",13,44,20,3,20,14,57,3,2,4,2,109,55,0,0,97,67,164,34789.0101388601
"1082",3,0,0,0,0,3,3,4,2,4,1,1,3,3,0,0,1,4,155547.03651449
"1083",6,0,6,0,0,0,6,3,1,2,1,0,22,22,0,0,0,22,41032.9950248202
"1084",1,12,0,0,12,1,13,4,1,3,2,6,42,0,0,12,36,48,80712.7333847078
"1085",1,0,0,0,0,1,1,6,2,3,1,0,0,0,0,0,0,0,216339.73243137
"1086",3,0,0,0,0,3,3,3,2,7,1,2,0,0,0,0,2,2,94930.2457335018
"1087",0,140,85,0,50,5,140,2,2,2,1,14,20,23,0,0,11,34,174082.796415153
"1088",7866,541,3033,0,0,5374,8407,4,2,1,1,0,300,300,0,0,0,300,39550.1886979049
"1089",0,0,0,0,0,0,0,6,2,7,2,1,2,0,0,0,3,3,41052.2604556745
"1090",3,7,7,0,0,3,10,3,1,4,1,3,12,10,0,0,5,15,203046.623123021
"1091",2,1,0,0,1,2,3,5,2,4,2,2,1,0,0,0,3,3,55385.2808438493
"1092",1,0,0,0,1,0,1,2,2,3,1,0,3,3,0,0,0,3,73472.4922267546
"1093",16,8,22,0,0,2,24,4,2,2,2,32,10,40,0,0,2,42,28649.1061120273
"1094",1,0,0,0,0,1,1,5,1,5,1,1,1,0,0,1,1,2,59628.2655860993
"1095",1,0,0,0,0,1,1,2,1,6,2,13,1,0,0,13,1,14,211722.288685134
"1096",2,0,0,0,0,2,2,4,2,5,1,3,1,0,0,1,3,4,437122.517032006
"1097",9,0,5,0,0,4,9,2,1,4,2,12,13,13,0,12,0,25,259144.50679839
"1098",11,3,5,0,3,6,14,2,2,4,1,2,17,12,0,1,6,19,188638.641497535
"1099",4,0,0,0,0,4,4,3,2,4,1,4,3,2,0,0,5,7,101046.688205004
"1100",2,0,0,0,0,2,2,3,2,3,1,7,0,0,0,2,5,7,410600.297004037
"1101",4,2,0,0,2,4,6,3,2,5,2,4,1,0,0,1,4,5,35988.0345909117
"1102",6,15,15,0,0,6,21,3,2,5,1,2,1,0,0,2,1,3,100190.838245572
"1103",2,5,0,0,5,2,7,4,2,3,1,2,0,0,0,0,2,2,82085.0894932003
"1104",0,0,0,0,0,0,0,3,2,4,1,2,1,0,0,3,0,3,41048.4043643185
"1105",5,0,0,0,0,5,5,2,2,3,2,4,0,0,0,0,4,4,50603.1658629359
"1106",0,0,0,0,0,0,0,5,2,2,1,0,2,0,0,2,0,2,258420.497477107
"1107",33,12,35,0,8,2,45,5,2,2,1,4,0,0,0,0,4,4,34371.9972021599
"1108",5,0,0,0,0,5,5,1,1,6,1,5,55,0,0,50,10,60,539957.475859467
"1109",15,0,10,0,0,5,15,3,2,4,1,5,4,0,0,5,4,9,240812.162523104
"1110",11,0,5,0,4,2,11,2,2,3,2,1,50,50,0,0,1,51,157101.152025331
"1111",2,10,10,0,0,2,12,2,2,6,2,2,10,10,0,0,2,12,75540.6876680814
"1112",4,6,0,0,0,10,10,5,2,1,1,2,64,0,0,62,4,66,54538.2218839368
"1113",0,0,0,0,0,0,0,5,1,4,1,52,0,0,0,0,52,52,39434.0900688395
"1114",0,1,0,0,0,1,1,4,2,3,5,0,10,10,0,0,0,10,23427.0730526149
"1115",0,0,0,0,0,0,0,4,2,3,5,0,7,7,0,0,0,7,15952.5572988915
"1116",1,0,0,0,0,1,1,4,1,3,1,2,11,10,0,0,3,13,19119.1203374769
"1117",21,0,18,0,0,3,21,4,1,8,1,3,1,0,0,1,3,4,36764.720774112
"1118",3,0,0,0,0,3,3,1,2,3,1,0,0,0,0,0,0,0,29753.8144634269
"1119",1,0,0,0,0,1,1,6,1,6,2,1,2,0,0,2,1,3,29019.7728062795
"1120",0,1,0,0,1,0,1,6,2,3,1,1,0,0,0,0,1,1,27309.9156526983
"1121",5,2,0,0,4,3,7,4,2,3,1,3,0,0,0,0,3,3,10119.8578443616
"1122",0,2,0,0,0,2,2,6,2,4,2,1,1,0,0,0,2,2,31282.557608535
"1123",3,4,1,0,5,1,7,5,2,3,4,4,0,3,0,0,1,4,65523.4223247772
"1124",1,0,0,0,0,1,1,2,1,5,2,0,2,0,0,2,0,2,101786.804755499
"1125",1,2,0,0,0,3,3,6,1,5,2,5,8,0,0,13,0,13,79999.2008908245
"1126",1,0,0,0,0,1,1,6,1,8,2,0,0,0,0,0,0,0,57310.0626289344
"1127",15,25,37,0,0,3,40,2,2,8,2,20,7,23,0,0,4,27,221248.204639164
"1128",3,4,0,0,2,5,7,5,1,7,2,0,1,0,0,1,0,1,102742.133598623
"1129",2,0,0,0,1,1,2,3,2,5,2,0,0,0,0,0,0,0,42007.4965701853
"1130",2,0,0,0,0,2,2,4,1,8,2,2,16,10,0,4,4,18,73383.0064925985
"1131",3,1,0,0,1,3,4,6,1,7,2,8,0,0,0,0,8,8,287053.528057255
"1132",1,3,0,0,2,2,4,2,1,3,2,1,4,0,0,3,2,5,52319.3905311828
"1133",7,4,0,0,4,7,11,1,2,2,1,7,0,2,0,5,0,7,200645.478351051
"1134",2,0,0,0,0,2,2,4,1,5,2,0,2,0,0,2,0,2,122577.33666013
"1135",1,2,0,0,1,2,3,2,2,6,2,1,13,13,0,0,1,14,82445.4211909312
"1136",4,2,0,0,2,4,6,3,2,5,2,4,3,0,0,3,4,7,46027.2657031476
"1137",3,1,0,0,1,3,4,3,1,6,2,3,6,0,0,6,3,9,31834.5406370766
"1138",2,5,0,0,5,2,7,4,2,6,2,14,6,11,0,5,4,20,87373.2092795224
"1139",1,1,0,0,1,1,2,6,1,6,2,1,1,0,0,0,2,2,26637.5407038979
"1140",7,2,3,0,0,6,9,2,1,4,2,3,5,3,0,0,5,8,539957.475859467
"1141",1,2,2,0,0,1,3,5,1,4,2,1,2,0,0,0,3,3,311348.100775863
"1142",1,5,0,0,5,1,6,6,2,6,2,1,0,0,0,0,1,1,64937.3189801233
"1143",0,0,0,0,0,0,0,6,2,4,2,0,0,0,0,0,0,0,21935.4008349822
"1144",0,2,0,0,2,0,2,6,1,2,2,0,1,0,0,0,1,1,22503.5405574384
"1145",1,12,7,0,4,2,13,3,1,4,2,1,5,5,0,0,1,6,127226.343404611
"1146",0,4,0,0,4,0,4,6,2,5,2,0,3,0,0,3,0,3,21749.6113524346
"1147",1,1,0,0,0,2,2,5,2,5,2,2,0,0,0,0,2,2,48971.2433848554
"1148",0,6,0,0,6,0,6,5,2,8,2,1,0,0,0,0,1,1,205909.454194831
"1149",3,6,3,0,4,2,9,4,2,2,2,0,2,0,0,2,0,2,15254.5101344797
"1150",2,4,3,0,0,3,6,6,2,3,2,1,2,0,0,0,3,3,66439.9381706863
"1151",1,3,3,0,0,1,4,5,1,7,2,2,4,0,0,4,2,6,181604.623336529
"1152",9,6,13,0,0,2,15,5,1,4,1,0,0,0,0,0,0,0,97744.5819853
"1153",3,2,2,0,0,3,5,3,1,7,2,3,3,0,0,3,3,6,143878.540002166
"1154",0,0,0,0,0,0,0,6,1,6,2,2,2,0,0,2,2,4,65822.524732458
"1155",1,1,0,0,1,1,2,4,2,4,2,1,2,0,0,2,1,3,36753.8247537697
"1156",0,0,0,0,0,0,0,3,1,6,2,10,10,20,0,0,0,20,147779.01996451
"1157",0,0,0,0,0,0,0,5,2,7,2,1,3,0,0,1,3,4,168977.672325789
"1158",1,1,0,0,1,1,2,5,2,6,2,0,0,0,0,0,0,0,100357.950652932
"1159",0,4,0,0,1,3,4,2,1,6,2,7,0,0,0,6,1,7,247674.440780863
"1160",3,3,0,0,3,3,6,2,1,4,1,3,3,3,0,2,1,6,498145.182473091
"1161",21,40,60,0,0,1,61,1,2,5,2,2,8,0,0,8,2,10,399793.779613945
"1162",13,0,11,0,0,2,13,2,2,5,2,0,16,16,0,0,0,16,73385.2122068749
"1163",24,10,0,0,33,1,34,5,2,6,2,1,1,0,0,2,0,2,59860.0117902882
"1164",3,12,0,7,4,4,15,3,2,8,2,5,3,0,0,2,6,8,180735.727404418
"1165",5,0,0,0,2,3,5,4,1,8,2,3,5,0,0,4,4,8,458271.062505412
"1166",1,2,0,0,2,1,3,5,2,8,2,1,0,0,0,0,1,1,90893.1835859762
"1167",4,8,1,0,4,7,12,6,1,4,2,1,7,7,0,1,0,8,539957.475859467
"1168",3,6,0,0,6,3,9,2,2,7,2,3,6,6,0,0,3,9,91607.5512513262
"1169",1,0,0,0,0,1,1,2,2,5,2,1,1,0,0,1,1,2,89446.446826468
"1170",6,0,0,0,0,6,6,3,2,6,4,5,5,0,0,5,5,10,106886.944633032
"1171",2,0,0,0,0,2,2,3,2,6,2,3,2,0,0,0,5,5,39824.3046340036
"1172",0,6,0,0,3,3,6,6,2,7,2,0,4,0,0,0,4,4,51832.1835714618
"1173",0,4,4,0,0,0,4,6,2,6,2,0,8,0,0,8,0,8,180615.739089761
"1174",1,1,0,0,0,2,2,3,2,3,1,0,0,0,0,0,0,0,27214.2756739914
"1175",3,3,0,0,0,6,6,3,1,7,2,1,2,0,0,2,1,3,244522.883115987
"1176",3,1,0,0,1,3,4,6,2,1,2,1,2,0,0,2,1,3,17988.5477026386
"1177",1,1,0,0,1,1,2,4,1,8,2,1,1,0,0,1,1,2,112826.948165255
"1178",1,0,0,0,0,1,1,6,1,8,2,1,0,0,0,0,1,1,124784.067385527
"1179",1,3,0,0,3,1,4,2,1,6,2,1,6,0,0,3,4,7,103528.877306523
"1180",1,0,0,0,0,1,1,6,2,6,2,1,4,0,0,4,1,5,42095.6384352328
"1181",5,0,2,0,0,3,5,4,2,3,2,3,6,6,0,0,3,9,29633.1972422727
"1182",1,2,0,0,2,1,3,6,1,5,2,8,4,0,0,11,1,12,177407.201716196
"1183",0,0,0,0,0,0,0,6,2,7,2,0,0,0,0,0,0,0,59955.3729632731
"1184",0,9,9,0,0,0,9,5,2,5,2,3,20,23,0,0,0,23,66694.5575526913
"1185",2,0,0,0,2,0,2,6,2,4,2,8,2,0,0,10,0,10,36816.3312673858
"1186",3,5,0,0,5,3,8,3,2,4,2,0,0,0,0,0,0,0,96632.1783085465
"1187",0,0,0,0,0,0,0,5,1,6,2,0,2,0,0,0,2,2,34753.1838594004
"1188",5,0,0,0,0,5,5,5,2,5,2,0,2,0,0,0,2,2,51081.068269176
"1189",5,1,0,0,0,6,6,4,2,5,2,3,0,0,0,0,3,3,37456.2458754092
"1190",2,8,3,0,4,3,10,2,2,6,2,2,5,0,0,4,3,7,103494.282921021
"1191",2,2,0,0,0,4,4,6,1,6,2,2,2,0,0,1,3,4,70175.8253734512
"1192",1,3,3,0,1,0,4,3,1,7,4,0,2,2,0,0,0,2,271870.312963174
"1193",3,5,0,0,2,6,8,3,1,6,1,3,0,0,0,0,3,3,539957.475859467
"1194",0,0,0,0,0,0,0,2,2,2,3,2,7,8,0,0,1,9,485446.489362701
"1195",2,2,2,0,1,1,4,5,2,4,2,1,1,0,0,1,1,2,32535.9964941011
"1196",2,2,0,0,2,2,4,4,1,5,2,2,1,0,0,1,2,3,135831.177129239
"1197",1,3,0,0,1,3,4,5,2,8,2,4,1,0,0,2,3,5,256863.257469626
"1198",3,0,0,0,0,3,3,1,2,5,2,66,0,25,30,5,6,66,399793.779613945
"1199",0,0,0,0,0,0,0,6,1,3,2,0,0,0,0,0,0,0,50363.6405310942
"1200",0,0,0,0,0,0,0,6,2,2,2,0,1,0,0,0,1,1,42940.1001389558
"1201",0,0,0,0,0,0,0,5,1,4,2,1,5,0,0,5,1,6,231044.869212752
"1202",0,0,0,0,0,0,0,5,2,3,2,0,2,0,0,2,0,2,21647.9583207789
"1203",4,3,3,0,0,4,7,1,2,4,2,1,0,0,0,0,1,1,128927.532250526
"1204",9,5,6,7,0,1,14,2,1,3,2,12,13,10,10,1,4,25,286031.944598878
"1205",1,0,0,0,0,1,1,3,2,4,2,7,5,11,0,0,1,12,64695.9074508225
"1206",1,0,0,0,0,1,1,5,2,4,2,1,1,0,0,1,1,2,78037.9169712051
"1207",16,34,0,0,43,7,50,6,2,3,2,19,25,0,0,29,15,44,56716.3426558433
"1208",1,0,0,0,0,1,1,3,1,5,2,1,5,4,0,0,2,6,88921.0083622628
"1209",0,2,0,0,0,2,2,5,2,3,2,0,3,0,0,0,3,3,209923.555972498
"1210",0,7,0,0,0,7,7,5,2,3,2,3,2,0,0,0,5,5,64499.9958706116
"1211",13,0,0,0,10,3,13,3,2,4,2,10,13,20,0,0,3,23,84676.3085277753
"1212",1,7,7,0,0,1,8,2,2,5,2,1,1,0,0,0,2,2,67034.3614504287
"1213",15,8,0,0,1,22,23,1,2,4,2,1,4,0,0,3,2,5,539957.475859467
"1214",0,18,18,0,0,0,18,4,2,5,3,0,10,10,0,0,0,10,279596.808640473
"1215",14,23,31,0,0,6,37,4,2,6,2,5,6,0,0,8,3,11,70628.0422329113
"1216",1,8,0,0,8,1,9,6,1,8,2,1,0,0,0,0,1,1,94021.6115764588
"1217",2,0,0,0,0,2,2,2,2,2,1,3,0,0,0,0,3,3,143301.64080027
"1218",0,4,0,0,0,4,4,6,2,3,2,0,2,0,0,2,0,2,15299.3076508265
"1219",2,5,0,0,6,1,7,5,2,5,2,16,66,44,0,35,3,82,80555.0561085293
"1220",1,0,0,0,0,1,1,5,1,8,2,1,1,0,0,0,2,2,57651.9242016222
"1221",18,0,15,0,0,3,18,2,2,6,2,12,0,9,0,0,3,12,66960.929852446
"1222",6,9,0,0,3,12,15,3,1,6,2,1,6,0,0,0,7,7,163563.893922649
"1223",0,0,0,0,0,0,0,2,2,7,3,1,0,0,0,0,1,1,333313.253459218
"1224",0,1,0,0,0,1,1,5,2,7,2,1,1,0,0,1,1,2,272607.26128569
"1225",0,2,0,0,0,2,2,5,1,8,2,6,26,26,0,4,2,32,142460.418880928
"1226",0,0,0,0,0,0,0,2,1,5,4,0,3,0,0,3,0,3,156538.762906827
"1227",1,28,28,0,0,1,29,5,2,6,2,1,1,0,0,1,1,2,51629.0857659355
"1228",0,1,0,0,1,0,1,2,2,4,2,0,0,0,0,0,0,0,60847.6986049095
"1229",9,9,12,0,0,6,18,3,1,7,2,10,27,0,0,27,10,37,418909.232981929
"1230",1,1,0,0,0,2,2,3,1,6,2,0,0,0,0,0,0,0,38873.2785146926
"1231",3,11,8,0,0,6,14,3,1,8,1,3,4,4,0,0,3,7,250590.212012886
"1232",1,0,0,0,0,1,1,5,1,3,2,4,3,0,0,7,0,7,29981.2987366429
"1233",1,5,0,0,2,4,6,4,2,4,1,7,7,0,0,12,2,14,67631.9952210448
"1234",25,0,0,0,0,25,25,4,2,1,2,50,0,48,0,0,2,50,39139.0844282841
"1235",2,2,0,0,0,4,4,4,1,6,2,2,0,0,0,0,2,2,99916.8989653812
"1236",1,6,0,0,7,0,7,6,1,6,2,1,5,0,0,0,6,6,83263.3339571292
"1237",13,2,12,0,0,3,15,4,2,8,4,2,1,0,0,0,3,3,402392.770039929
"1238",1,20,20,0,0,1,21,5,1,5,2,1,10,10,0,0,1,11,19126.3589284524
"1239",1,0,0,0,0,1,1,4,2,7,2,4,0,0,0,3,1,4,104724.763056186
"1240",1,0,0,0,0,1,1,6,2,7,2,1,3,0,0,3,1,4,52089.9616050342
"1241",3,0,0,0,0,3,3,3,2,5,2,3,1,0,0,1,3,4,49982.1836833423
"1242",7,0,0,0,0,7,7,6,2,8,2,2,0,0,0,0,2,2,301299.799024906
"1243",12,10,21,0,0,1,22,1,2,3,2,3,5,6,0,1,1,8,43098.5992520206
"1244",3,1,0,0,1,3,4,2,2,3,2,4,1,1,0,0,4,5,37452.0280699247
"1245",12,0,10,0,0,2,12,4,1,6,2,4,3,0,0,5,2,7,164235.913414595
"1246",4,4,3,0,0,5,8,6,1,3,2,1,0,0,0,0,1,1,37700.4711800825
"1247",0,3,0,0,1,2,3,6,2,3,2,0,2,0,0,2,0,2,78712.1813786206
"1248",1,1,0,0,1,1,2,5,1,4,2,2,2,4,0,0,0,4,19505.5017184929
"1249",1,7,5,0,2,1,8,5,2,5,2,1,1,0,0,0,2,2,80555.0561085293
"1250",1,0,0,0,0,1,1,6,1,6,2,1,1,0,0,1,1,2,83263.3339571292
"1251",0,6,0,0,6,0,6,4,1,7,2,6,2,0,0,2,6,8,311180.111894199
"1252",0,3,0,0,0,3,3,5,2,4,2,0,0,0,0,0,0,0,33872.349561794
"1253",6,2,0,0,7,1,8,2,2,3,2,0,3,2,0,0,1,3,60442.7240409622
"1254",8,55,60,0,0,3,63,5,1,6,2,1,25,25,0,0,1,26,66215.1641886215
"1255",7,6,9,0,2,2,13,5,2,5,2,22,16,10,0,26,2,38,182060.297012528
"1256",1,0,0,0,0,1,1,5,1,8,2,1,2,0,0,0,3,3,57651.9242016222
"1257",2,4,6,0,0,0,6,4,2,8,2,36,0,0,0,0,36,36,111648.500619426
"1258",2,0,0,0,0,2,2,4,2,6,3,3,17,0,0,16,4,20,159706.422949142
"1259",9,8,0,0,8,9,17,6,2,2,2,1,1,0,0,1,1,2,192190.814301679
"1260",1,0,0,0,0,1,1,6,1,4,2,1,7,0,0,5,3,8,495246.958784712
"1261",3,4,0,0,0,7,7,3,2,6,2,3,3,0,0,0,6,6,77167.4428935905
"1262",0,0,0,0,0,0,0,6,1,3,2,1,2,0,0,0,3,3,61969.2102590851
"1263",1,8,0,0,9,0,9,5,2,2,2,0,5,0,0,1,4,5,28126.0402637183
"1264",0,2,0,0,2,0,2,3,2,7,3,1,2,0,0,1,2,3,384118.492808706
"1265",2,1,0,0,1,2,3,6,2,3,2,4,4,0,0,3,5,8,29586.6468679469
"1266",3,5,0,0,2,6,8,2,2,2,2,3,0,0,0,2,1,3,109759.070377148
"1267",1,2,0,0,2,1,3,5,2,3,2,1,2,0,0,2,1,3,43417.5341762011
"1268",0,13,0,0,12,1,13,4,2,3,3,0,0,0,0,0,0,0,89979.699543592
"1269",10,5,9,4,0,2,15,4,2,3,2,7,10,9,3,4,1,17,61567.7668230383
"1270",3,0,0,0,2,1,3,6,2,5,2,1,2,0,0,2,1,3,79874.7198526868
"1271",5,1,0,0,6,0,6,6,2,3,2,2,2,0,0,0,4,4,154000.519484771
"1272",3,1,0,0,1,3,4,6,1,5,2,2,0,0,0,1,1,2,31686.2390247213
"1273",79,0,55,3,20,1,79,3,2,7,2,28,14,11,28,3,0,42,20009.77864235
"1274",0,1,0,0,0,1,1,6,1,6,2,1,0,0,0,0,1,1,3317.8673383973
"1275",8,4,9,0,0,3,12,4,1,3,4,0,1,0,0,1,0,1,4333.66400804118
"1276",20,2,10,0,4,8,22,1,2,2,2,20,7,22,0,3,2,27,108052.632176135
"1277",2,10,0,0,0,12,12,6,2,8,2,1,1,0,0,1,1,2,31367.6643540619
"1278",1,2,0,0,0,3,3,4,2,6,2,1,1,0,0,0,2,2,13867.6292552398
"1279",1,11,0,0,10,2,12,5,2,4,2,1,2,0,0,0,3,3,30627.2500826607
"1280",8,8,0,0,14,2,16,4,2,8,1,11,10,0,0,18,3,21,71534.2787550756
"1281",3,0,0,0,0,3,3,3,1,4,2,2,0,0,0,2,0,2,13520.7080834729
"1282",1,5,3,0,0,3,6,4,1,7,2,2,0,0,0,0,2,2,96405.1002680714
"1283",0,5,0,0,5,0,5,6,2,4,2,1,2,0,0,2,1,3,23599.1674889983
"1284",23,0,0,0,22,1,23,4,1,4,1,1,0,0,0,0,1,1,28587.5897975919
"1285",0,0,0,0,0,0,0,5,2,2,2,0,0,0,0,0,0,0,226936.811711886
"1286",3,0,0,0,0,3,3,3,2,7,2,3,160,160,0,0,3,163,68304.4539301076
"1287",0,0,0,0,0,0,0,6,1,5,2,1,10,0,0,10,1,11,24914.68011656
"1288",0,2,0,0,2,0,2,3,1,3,2,0,7,7,0,0,0,7,51493.9065255589
"1289",18,7,0,0,25,0,25,5,2,4,2,1,1,0,0,0,2,2,71191.3167157511
"1290",1,4,3,0,0,2,5,4,2,5,2,2,0,0,0,0,2,2,109727.473010172
"1291",3,3,0,0,1,5,6,3,2,6,2,16,5,15,0,3,3,21,179895.564836657
"1292",1,2,0,0,1,2,3,6,2,8,2,1,0,0,0,0,1,1,107075.206730796
"1293",2,0,0,0,0,2,2,3,1,6,2,2,55,55,0,0,2,57,38873.2785146926
"1294",29,32,24,0,32,5,61,3,1,2,2,6,5,0,0,6,5,11,52406.395465426
"1295",4,0,0,0,4,0,4,6,1,3,2,0,6,0,0,0,6,6,9864.8991264382
"1296",3,0,0,0,3,0,3,3,2,8,1,5,0,0,0,5,0,5,212944.140742217
"1297",1,1,0,0,0,2,2,6,2,6,2,1,0,0,0,0,1,1,27353.8155126146
"1298",4,1,0,0,1,4,5,5,2,4,1,3,4,0,0,4,3,7,45305.5194601641
"1299",5,3,0,0,3,5,8,6,2,8,2,0,0,0,0,0,0,0,172291.961561626
"1300",1,16,15,0,0,2,17,3,1,5,5,6,6,0,0,10,2,12,95299.8500618547
"1301",0,194,0,0,190,4,194,4,2,2,1,5,6,0,0,8,3,11,43454.4983359724
"1302",2,0,0,0,0,2,2,4,2,4,2,3,1,0,0,2,2,4,36475.1693749222
"1303",3,1,0,0,0,4,4,5,2,6,2,0,0,0,0,0,0,0,108981.262453651
"1304",1,4,3,0,0,2,5,4,1,7,2,2,3,3,0,1,1,5,76612.9595065376
"1305",13,30,41,0,0,2,43,1,1,3,1,12,43,51,0,0,4,55,131763.148836916
"1306",4,2,0,0,6,0,6,6,1,8,2,1,0,0,0,0,1,1,72495.3487149347
"1307",1,1,0,0,1,1,2,4,2,7,2,1,0,0,0,0,1,1,104724.763056186
"1308",1,0,0,0,0,1,1,5,2,4,2,1,0,0,0,0,1,1,40709.2591591733
"1309",1,1,0,0,2,0,2,6,2,4,2,0,2,0,0,2,0,2,38328.4907993458
"1310",0,2,0,0,0,2,2,5,2,4,2,0,4,0,0,1,3,4,71191.3167157511
"1311",0,33,30,0,3,0,33,5,1,5,1,10,10,15,0,5,0,20,59028.4348861681
"1312",0,1,0,0,1,0,1,6,1,1,2,0,0,0,0,0,0,0,90759.4605102147
"1313",0,40,35,0,0,5,40,2,2,7,2,11,20,23,8,0,0,31,98795.9546226183
"1314",6,15,9,0,0,12,21,2,1,5,5,2,4,0,0,2,4,6,276508.222804068
"1315",3,0,0,0,1,2,3,1,2,6,2,1,10,9,0,0,2,11,89399.3837058669
"1316",3,9,6,2,0,4,12,3,1,7,2,6,7,0,0,8,5,13,37351.2276502707
"1317",0,2,0,0,0,2,2,4,2,4,2,2,2,0,0,2,2,4,60826.4166282445
"1318",0,0,0,0,0,0,0,6,1,3,2,1,0,0,0,0,1,1,31425.7730504293
"1319",1,0,0,0,0,1,1,6,1,6,5,3,0,1,0,0,2,3,140798.10549758
"1320",6,6,10,0,0,2,12,2,1,5,2,2,2,0,0,2,2,4,187388.38990918
"1321",5,0,0,0,0,5,5,5,1,6,2,1,0,0,0,0,1,1,77288.0088382977
"1322",28,110,0,0,135,3,138,3,2,8,2,293,0,155,0,135,3,293,164088.231175767
"1323",2,2,0,0,0,4,4,5,2,5,2,2,2,0,0,0,4,4,21926.6074334592
"1324",0,1,0,0,0,1,1,5,2,7,2,0,1,0,0,0,1,1,77247.0191577498
"1325",3,42,45,0,0,0,45,4,2,3,2,6,19,25,0,0,0,25,35001.4758143396
"1326",2,4,0,0,3,3,6,6,1,4,2,49,0,24,0,20,5,49,50637.1508538078
"1327",4,7,11,0,0,0,11,3,1,4,2,0,15,12,0,3,0,15,35458.6064628431
"1328",0,1,0,0,0,1,1,6,1,4,2,5,5,10,0,0,0,10,251149.215321846
"1329",0,0,0,0,0,0,0,6,2,4,2,0,0,0,0,0,0,0,33357.5720156822
"1330",2,2,0,0,4,0,4,4,2,6,2,0,64,64,0,0,0,64,66291.4882419226
"1331",0,262,250,0,0,12,262,4,2,2,2,355,403,750,0,0,8,758,232499.398829856
"1332",3,0,0,0,0,3,3,2,2,2,2,6,0,0,0,0,6,6,71444.3711348905
"1333",2,0,0,0,0,2,2,4,2,4,2,63,27,85,0,0,5,90,176497.522236782
"1334",5,9,0,0,12,2,14,6,1,6,2,0,0,0,0,0,0,0,17087.691505353
"1335",8,0,0,0,3,5,8,5,2,5,2,0,0,0,0,0,0,0,93672.9583881582
"1336",0,1,0,0,1,0,1,5,2,6,2,0,1,0,0,1,0,1,108239.156890372
"1337",10,8,0,15,0,3,18,1,2,1,2,10,0,0,0,0,10,10,46922.3923315362
"1338",0,0,0,0,0,0,0,6,1,3,2,16,0,0,0,16,0,16,161834.611453036
"1339",1,5,5,0,0,1,6,5,1,5,2,1,8,8,0,0,1,9,57147.0804368624
"1340",0,0,0,0,0,0,0,6,1,5,2,0,0,0,0,0,0,0,12562.9443470342
"1341",3,8,0,0,8,3,11,3,1,5,2,7,0,3,0,1,3,7,284108.864839415
"1342",0,3,0,0,3,0,3,6,2,3,3,0,4,0,0,2,2,4,74879.1116818076
"1343",1,0,0,0,0,1,1,5,2,4,3,0,0,0,0,0,0,0,288663.822241309
"1344",1,0,0,0,0,1,1,6,2,6,3,1,1,0,0,0,2,2,539957.475859467
"1345",0,8,0,0,0,8,8,6,1,4,2,0,3,0,0,3,0,3,30735.754614758
"1346",20,15,11,10,12,2,35,5,1,6,2,6,6,0,0,10,2,12,13588.9862302899
"1347",4,0,0,0,3,1,4,6,2,5,2,4,0,0,0,4,0,4,228950.48470901
"1348",3,1,0,0,1,3,4,4,2,7,2,4,3,0,0,4,3,7,83915.2935663945
"1349",5,8,11,0,0,2,13,1,1,7,2,3,122,123,0,0,2,125,539957.475859467
"1350",17,3,0,15,0,5,20,1,1,1,2,6,3,0,7,0,2,9,266209.405746
"1351",1,1,0,0,0,2,2,6,1,3,2,0,16,16,0,0,0,16,313483.577047413
"1352",0,1,0,0,1,0,1,5,1,5,2,1,26,14,0,13,0,27,81428.1850774193
"1353",9,0,0,0,1,8,9,2,2,2,2,106,0,80,0,19,7,106,56866.7531448316
"1354",1,1,0,0,0,2,2,6,2,5,2,0,0,0,0,0,0,0,228950.48470901
"1355",2,0,0,0,0,2,2,3,2,5,2,2,5,3,0,2,2,7,250542.422333649
"1356",1,5,0,0,2,4,6,4,2,3,2,1,8,8,0,0,1,9,12782.8438327909
"1357",0,85,85,0,0,0,85,6,2,3,2,0,39,39,0,0,0,39,34599.1974261103
"1358",1,0,0,0,0,1,1,6,2,6,2,0,35,0,0,35,0,35,58534.6214489283
"1359",1,0,0,0,0,1,1,2,1,6,2,1,0,0,0,0,1,1,183567.401626457
"1360",3,2,0,0,2,3,5,3,1,5,2,3,0,0,0,0,3,3,69769.7073829927
"1361",9,0,5,0,0,4,9,1,2,3,3,40,0,10,10,10,10,40,488197.532937714
"1362",6,5,0,0,8,3,11,3,1,5,2,3,0,0,0,0,3,3,69769.7073829927
"1363",1,0,0,0,0,1,1,6,2,5,2,2,0,0,0,1,1,2,228950.48470901
"1364",25,25,0,0,30,20,50,3,1,3,2,2,2,0,0,0,4,4,413330.238100639
"1365",4,6,0,0,3,7,10,6,1,3,2,2,2,0,0,0,4,4,38364.2620086967
"1366",14,0,0,0,0,14,14,6,2,3,2,1,0,0,0,0,1,1,153634.401102744
"1367",3,5,0,0,7,1,8,6,2,8,2,1,1,0,0,0,2,2,539957.475859467
"1368",2,0,1,0,0,1,2,4,1,2,2,1,0,0,0,0,1,1,275759.503702543
"1369",1,2,0,0,2,1,3,6,2,5,2,1,0,0,0,0,1,1,64003.1103376731
"1370",1,1,0,0,1,1,2,6,2,3,2,0,0,0,0,0,0,0,148307.049207538
"1371",0,1,0,0,0,1,1,6,2,3,2,0,2,0,0,2,0,2,317476.007254414
"1372",0,0,0,0,0,0,0,4,2,3,2,0,5,0,0,5,0,5,20568.5452826125
"1373",3,0,0,0,2,1,3,6,1,3,2,1,5,0,0,5,1,6,63060.2998963992
"1374",5,0,0,0,3,2,5,2,1,6,2,0,1,0,0,0,1,1,92625.8977193848
"1375",4,17,0,0,13,8,21,4,2,3,4,4,0,0,0,0,4,4,35647.0189722951
"1376",3,2,0,0,3,2,5,6,1,3,2,1,2,0,0,2,1,3,539957.475859467
"1377",9,0,1,0,6,2,9,3,1,6,2,22,0,20,0,0,2,22,539957.475859467
"1378",0,1,0,0,1,0,1,6,2,4,2,0,1,0,0,1,0,1,66868.5385412087
"1379",3,2,0,0,0,5,5,4,1,5,2,10,2,0,0,0,12,12,119289.838824131
"1380",1,1,0,0,0,2,2,5,2,2,2,0,0,0,0,0,0,0,136096.81514151
"1381",42,394,79,73,239,45,436,4,2,3,2,2,4,0,0,0,6,6,49333.8640872429
"1382",1,0,0,0,0,1,1,6,1,4,2,1,1,0,0,0,2,2,63891.1374599018
"1383",0,0,0,0,0,0,0,3,1,1,2,1,0,0,0,0,1,1,24496.0239867083
"1384",5,0,0,0,4,1,5,2,1,2,2,1,8,0,0,7,2,9,68196.25904946
"1385",1,0,0,0,0,1,1,2,2,2,1,1,1,0,0,1,1,2,119542.987447616
"1386",4,2,5,0,0,1,6,3,2,6,1,1,0,0,0,0,1,1,52232.6067018217
"1387",1,1,0,0,1,1,2,6,1,6,2,1,0,0,0,0,1,1,34288.8924048279
"1388",2,4,4,0,0,2,6,4,1,6,2,3,1,2,0,0,2,4,539957.475859467
"1389",6,8,0,0,9,5,14,3,1,7,2,5,2,0,0,2,5,7,185206.128160927
"1390",204,162,360,0,0,6,366,3,1,5,2,0,223,20,150,50,3,223,28234.9154467645
"1391",2,0,0,0,1,1,2,5,1,4,2,0,0,0,0,0,0,0,80620.7417264184
"1392",3,3,0,0,3,3,6,6,1,3,2,2,30,32,0,0,0,32,63060.2998963992
"1393",0,0,0,0,0,0,0,3,1,4,2,4,0,0,0,0,4,4,28794.6176179456
"1394",3,2,0,0,0,5,5,6,2,3,2,0,10,0,0,0,10,10,19726.0261093402
"1395",2,3,0,0,0,5,5,6,1,5,2,1,1,0,0,0,2,2,60476.8438351989
"1396",2,34,34,0,0,2,36,4,2,5,2,29,81,68,0,17,25,110,23716.7476623183
"1397",20,0,0,0,0,20,20,5,1,6,2,4,6,5,0,0,5,10,27268.2408033369
"1398",3,5,0,0,5,3,8,2,1,6,2,3,4,4,0,0,3,7,52402.7537588755
"1399",4,47,48,0,3,0,51,4,1,3,2,4,65,69,0,0,0,69,76148.5053487454
"1400",5,0,0,0,4,1,5,5,2,4,2,2,1,0,0,2,1,3,57045.1540518195
"1401",6,0,0,0,0,6,6,3,2,4,2,7,0,0,0,0,7,7,78921.9310523121
"1402",0,8,0,0,8,0,8,6,2,4,2,1,4,0,0,0,5,5,103655.356302806
"1403",1,7,7,0,0,1,8,5,2,5,2,1,0,0,0,0,1,1,209600.275233227
"1404",0,50,0,0,50,0,50,6,2,5,4,1,0,0,0,0,1,1,84921.0022147823
"1405",0,0,0,0,0,0,0,4,1,6,2,0,3,0,0,0,3,3,428517.601493567
"1406",0,0,0,0,0,0,0,5,1,3,2,0,3,3,0,0,0,3,82948.6038038894
"1407",0,0,0,0,0,0,0,5,2,4,2,1,4,0,0,4,1,5,394810.795786314
"1408",0,0,0,0,0,0,0,6,2,3,2,1,0,0,0,0,1,1,47313.0733208558
"1409",2,3,0,0,3,2,5,2,2,2,2,1,8,8,0,0,1,9,50291.9326616635
"1410",10,8,5,0,5,8,18,6,1,6,2,5,5,5,0,0,5,10,34288.8924048279
"1411",21,56,75,0,0,2,77,2,2,7,2,1,2,0,0,0,3,3,359681.532360216
"1412",0,1,0,0,0,1,1,5,1,7,2,0,8,0,0,7,1,8,266600.503984917
"1413",8,6,14,0,0,0,14,4,2,3,2,9,5,12,0,0,2,14,126994.192274046
"1414",0,0,0,0,0,0,0,6,2,3,2,1,5,0,0,6,0,6,18021.8866898658
"1415",2,36,27,0,0,11,38,3,2,8,2,2,0,0,0,0,2,2,202093.444925243
"1416",3,0,0,0,0,3,3,4,2,5,2,4,0,0,0,1,3,4,34761.5620088379
"1417",6,0,0,0,5,1,6,6,1,4,2,0,0,0,0,0,0,0,132661.976991199
"1418",2,2,0,0,0,4,4,6,1,7,2,10,2,0,0,0,12,12,203952.070639503
"1419",3,2,0,0,2,3,5,2,1,8,2,2,0,0,0,0,2,2,138265.789653147
"1420",6,4,5,0,0,5,10,5,1,6,2,0,20,20,0,0,0,20,85602.8216540958
"1421",2,2,1,0,2,1,4,2,2,4,2,1,40,0,0,40,1,41,161826.217142885
"1422",4,1,0,0,4,1,5,2,2,4,2,1,0,0,0,0,1,1,213837.334913087
"1423",3,5,0,0,6,2,8,4,2,4,2,2,0,0,0,0,2,2,48623.7279083455
"1424",3,12,12,0,0,3,15,2,2,5,2,3,67,67,0,0,3,70,81962.381528316
"1425",0,2,0,0,0,2,2,4,2,3,2,1,3,0,0,0,4,4,398074.625060476
"1426",5,25,25,0,2,3,30,3,2,7,2,3,0,0,0,0,3,3,80220.4152656301
"1427",4,0,0,0,0,4,4,3,2,7,2,6,6,0,0,0,12,12,207280.092992976
"1428",1,30,28,0,2,1,31,4,2,5,2,59,47,90,0,15,1,106,55933.9354861709
"1429",22,0,0,0,15,7,22,5,1,4,2,1,0,0,0,0,1,1,62311.492772434
"1430",1,0,0,0,0,1,1,6,1,3,2,1,0,0,0,0,1,1,398258.765610253
"1431",4,10,8,0,0,6,14,5,1,8,2,6,0,0,0,0,6,6,74532.2834417283
"1432",3,4,0,0,0,7,7,5,2,4,5,0,4,0,0,2,2,4,158104.603542414
"1433",0,0,0,0,0,0,0,2,2,4,2,0,2,0,0,2,0,2,110777.090986116
"1434",2,0,0,0,1,1,2,6,2,6,2,1,2,0,0,0,3,3,77801.9056014036
"1435",0,2,0,0,2,0,2,6,2,3,2,0,0,0,0,0,0,0,358641.439342988
"1436",1,1,0,0,1,1,2,5,2,4,2,4,0,0,0,4,0,4,126130.306283242
"1437",76,86,0,0,0,162,162,5,1,2,2,1,0,0,0,0,1,1,40951.1455580579
"1438",2,13,13,0,0,2,15,3,2,7,2,2,0,0,0,0,2,2,80376.3858423252
"1439",0,1,0,0,1,0,1,3,2,4,1,1,0,0,0,0,1,1,262154.465611885
"1440",1,3,0,0,0,4,4,6,1,3,2,1,2,0,0,2,1,3,15525.5301279523
"1441",0,0,0,0,0,0,0,5,1,8,2,1,0,0,0,0,1,1,58666.9995399171
"1442",1,1,0,0,0,2,2,6,1,5,2,1,0,0,0,0,1,1,99407.3053763115
"1443",1,268,265,0,0,4,269,4,2,3,2,0,2061,2060,0,0,1,2061,272403.660459791
"1444",0,3,0,0,2,1,3,6,1,8,2,1,0,0,0,0,1,1,73771.7716902418
"1445",0,0,0,0,0,0,0,2,2,4,1,0,1,0,0,1,0,1,63973.6550107911
"1446",1,0,0,0,0,1,1,4,1,3,2,1,0,0,0,0,1,1,46037.5282711838
"1447",3,22,20,0,3,2,25,6,2,7,2,1,3,3,0,0,1,4,66962.1313261952
"1448",0,1,0,0,0,1,1,6,1,5,2,2,0,0,0,0,2,2,24474.2114625847
"1449",1,1,0,0,1,1,2,6,2,3,2,4,1,0,0,3,2,5,19726.0261093402
"1450",4,0,0,0,0,4,4,2,1,5,2,7,18,19,0,0,6,25,205356.164105699
"1451",2,3,0,0,4,1,5,6,1,4,2,2,2,0,0,3,1,4,101377.861468654
"1452",4,0,0,0,0,4,4,5,2,3,2,2,1,0,0,1,2,3,27993.6676511877
"1453",2,0,0,0,0,2,2,6,2,2,2,2,0,0,0,0,2,2,86285.5955353479
"1454",1,5,0,0,0,6,6,6,1,4,2,3,2,0,0,0,5,5,78354.5989148203
"1455",40,51,78,0,11,2,91,2,2,3,2,1,3,0,0,2,2,4,73537.1151984014
"1456",2,0,0,0,0,2,2,3,2,4,2,3,1,0,0,1,3,4,30705.3326523358
"1457",3,0,0,0,0,3,3,5,1,3,4,7,11,0,0,6,12,18,37706.7186014957
"1458",0,12,12,0,0,0,12,5,1,3,2,3,30,30,0,0,3,33,316715.273111913
"1459",2,2,1,0,2,1,4,6,2,7,2,5,29,0,0,33,1,34,117956.341744874
"1460",0,0,0,0,0,0,0,6,2,4,2,0,0,0,0,0,0,0,89836.1808314037
"1461",2,2,0,2,0,2,4,3,2,6,2,3,3,0,3,0,3,6,90629.5850083942
"1462",9,0,8,0,0,1,9,2,1,4,1,2,0,0,0,2,0,2,272768.801977462
"1463",3,5,0,0,3,5,8,2,2,4,2,7,0,0,0,0,7,7,110777.090986116
"1464",1,30,30,0,0,1,31,2,1,3,1,3,40,43,0,0,0,43,539957.475859467
"1465",4,2,0,0,2,4,6,6,1,6,2,0,0,0,0,0,0,0,107642.65881383
"1466",1,3,0,0,3,1,4,4,1,5,2,0,3,2,0,1,0,3,154745.182562803
"1467",11,10,13,0,3,5,21,5,2,7,2,2,8,8,0,1,1,10,188844.961816641
"1468",4,0,0,0,0,4,4,2,2,3,2,4,0,0,0,4,0,4,141993.932988187
"1469",1,0,0,0,0,1,1,6,1,6,2,1,0,0,0,0,1,1,43561.618416853
"1470",1,2,0,0,2,1,3,5,2,5,2,1,2,2,0,0,1,3,47406.1850197966
"1471",0,4,0,0,4,0,4,2,1,1,4,0,3,0,0,3,0,3,95666.619565521
"1472",0,0,0,0,0,0,0,6,1,7,2,1,3,3,0,0,1,4,82536.8155564693
"1473",0,6,0,0,5,1,6,6,1,3,2,0,11,0,0,10,1,11,50489.8494494139
"1474",0,50,50,0,0,0,50,5,2,8,2,0,90,90,0,0,0,90,86451.4715014006
"1475",0,8,8,0,0,0,8,5,2,5,3,0,0,0,0,0,0,0,79860.2011133374
"1476",5,6,0,0,11,0,11,6,1,4,2,2,1,0,0,1,2,3,230421.777939515
"1477",1,2,0,0,0,3,3,5,2,4,2,1,8,8,0,0,1,9,71565.7027807934
"1478",3,7,6,0,0,4,10,4,2,5,2,9,4,0,0,0,13,13,91177.6653863894
"1479",3,0,0,0,0,3,3,3,2,5,2,5,0,0,0,0,5,5,450969.055670443
"1480",7,3,1,0,5,4,10,6,1,8,2,4,0,1,0,0,3,4,112221.398594196
"1481",0,0,0,0,0,0,0,6,1,3,2,0,0,0,0,0,0,0,297645.869452113
"1482",0,4,0,0,4,0,4,6,1,4,2,1,1,0,0,2,0,2,39108.5564083716
"1483",0,19,0,0,19,0,19,6,1,6,2,1,6,0,0,6,1,7,128890.03162157
"1484",3,2,0,0,4,1,5,5,1,6,5,1,0,0,0,0,1,1,222112.083198027
"1485",1,12,8,0,0,5,13,3,2,5,5,4,36,36,0,0,4,40,237370.701207433
"1486",1,0,0,0,0,1,1,4,1,6,2,1,5,0,0,0,6,6,203772.951818953
"1487",20,0,0,0,20,0,20,6,1,5,2,0,0,0,0,0,0,0,37230.0973244033
"1488",4,3,0,0,2,5,7,3,1,5,2,4,4,0,0,5,3,8,106133.470332026
"1489",1,0,0,0,0,1,1,2,1,3,2,0,0,0,0,0,0,0,157649.023520678
"1490",0,26,24,0,0,2,26,4,2,2,2,2,0,1,0,0,1,2,293130.13324651
"1491",7,3,0,0,10,0,10,5,1,6,5,4,2,0,2,4,0,6,352053.600366227
"1492",0,8,0,0,0,8,8,6,2,2,2,4,1,0,0,0,5,5,369523.744436949
"1493",7,1,0,0,1,7,8,6,2,6,2,68,68,0,0,0,136,136,539957.475859467
"1494",3,2,0,0,4,1,5,2,1,6,2,2,2,0,0,4,0,4,87946.2845235397
"1495",0,9,6,0,2,1,9,5,1,3,2,1,0,0,0,0,1,1,379231.078238507
"1496",4,4,0,0,0,8,8,1,2,6,2,4,0,0,0,0,4,4,539957.475859467
"1497",1,0,0,0,0,1,1,6,2,3,2,0,6,0,0,6,0,6,26950.2636501011
"1498",23,11,33,0,0,1,34,4,2,8,2,0,3,0,0,3,0,3,259111.203543838
"1499",0,6,0,0,0,6,6,6,2,6,2,0,0,0,0,0,0,0,64233.5129653883
"1500",2,3,0,0,3,2,5,5,2,5,2,2,1,0,0,0,3,3,28448.8591559445
"1501",7,0,5,0,0,2,7,3,1,7,2,2,18,20,0,0,0,20,114014.583752038
"1502",3,7,2,0,7,1,10,2,2,4,4,3,0,3,0,0,0,3,157514.562652417
"1503",1,0,0,0,0,1,1,2,2,7,4,1,0,0,0,0,1,1,242256.527780027
"1504",0,13,8,0,4,1,13,5,1,6,2,10,0,5,0,4,1,10,106181.699384313
"1505",0,0,0,0,0,0,0,5,1,5,3,6,5,5,0,4,2,11,403643.150254566
"1506",0,3,0,0,0,3,3,5,1,6,2,0,3,0,0,0,3,3,539957.475859467
"1507",1,2,0,0,2,1,3,2,2,4,2,1,2,0,0,1,2,3,103022.722526036
"1508",5,1,0,0,1,5,6,3,2,8,2,5,0,0,0,0,5,5,206404.835115707
"1509",4,0,0,0,0,4,4,3,1,5,2,15,11,2,0,20,4,26,244285.120717108
"1510",8,15,0,0,23,0,23,6,1,5,2,3,4,0,0,7,0,7,91997.1940791349
"1511",0,34,30,0,4,0,34,2,2,3,1,10,0,9,0,0,1,10,232070.02385683
"1512",1,7,0,0,8,0,8,5,1,6,2,0,0,0,0,0,0,0,105578.572015258
"1513",7,0,0,0,0,7,7,5,2,4,2,6,0,0,0,0,6,6,27696.9694144552
"1514",2,2,0,0,2,2,4,4,2,8,2,2,8,0,0,6,4,10,196672.725100046
"1515",0,0,0,0,0,0,0,3,2,5,2,5,0,0,0,2,3,5,45686.4573152173
"1516",0,0,0,0,0,0,0,6,2,4,1,21,0,20,0,0,1,21,137864.058012686
"1517",6,0,0,0,3,3,6,6,1,8,2,1,1,0,0,1,1,2,72886.4723061989
"1518",1,0,0,0,0,1,1,3,2,8,2,2,1,0,0,1,2,3,179059.038965321
"1519",4,2,4,0,0,2,6,5,2,4,2,1,0,0,0,1,0,1,65354.422119046
"1520",0,10,0,0,8,2,10,1,1,3,2,0,2,1,0,0,1,2,82926.4224117482
"1521",4,4,0,0,8,0,8,4,1,8,2,4,9,5,0,3,5,13,87464.5530421735
"1522",1,0,0,0,0,1,1,6,2,3,2,1,0,0,0,1,0,1,47498.2411479044
"1523",0,2,0,0,2,0,2,5,1,8,2,0,0,0,0,0,0,0,26310.0761035399
"1524",1,9,6,0,1,3,10,2,1,3,2,0,1,0,0,0,1,1,134897.715597393
"1525",0,0,0,0,0,0,0,6,2,4,2,0,0,0,0,0,0,0,68109.3504819978
"1526",1,3,2,0,1,1,4,5,2,6,2,1,8,8,0,0,1,9,42730.4772966352
"1527",4,7,0,0,7,4,11,2,2,5,2,4,0,0,0,0,4,4,153662.606639066
"1528",45,0,40,0,4,1,45,5,1,4,2,11,33,40,0,2,2,44,79653.2511625322
"1529",1,1,0,0,1,1,2,5,2,8,2,1,3,0,0,0,4,4,293777.327225447
"1530",1,4,0,0,1,4,5,1,2,1,2,2,3,1,0,0,4,5,30877.0827213058
"1531",2,0,0,0,0,2,2,6,1,3,2,0,0,0,0,0,0,0,37903.8710387174
"1532",4,2,0,1,0,5,6,3,1,8,2,3,0,0,0,0,3,3,84086.1976666574
"1533",1,0,0,0,0,1,1,6,1,5,2,0,2,0,0,0,2,2,488240.476628322
"1534",1,4,0,0,3,2,5,1,2,1,2,4,10,0,9,5,0,14,47517.4179514002
"1535",0,1,0,0,0,1,1,5,1,6,2,0,1,0,0,0,1,1,68572.0349391197
"1536",1,1,0,0,1,1,2,4,2,3,2,1,2,0,0,2,1,3,41714.5908768736
"1537",1,0,0,0,0,1,1,5,1,7,2,1,6,0,0,6,1,7,51045.5091964926
"1538",1,0,0,0,0,1,1,4,1,6,2,1,1,0,0,0,2,2,100455.966050981
"1539",0,1,0,0,0,1,1,6,1,5,2,4,0,0,0,0,4,4,38829.5198801227
"1540",1,0,0,0,0,1,1,6,2,7,2,0,0,0,0,0,0,0,193782.729650948
"1541",12,0,0,0,10,2,12,3,2,7,2,12,20,25,0,2,5,32,178077.342523174
"1542",3,24,24,0,2,1,27,2,2,7,2,4,5,5,0,0,4,9,168968.173341159
"1543",6,0,0,0,0,6,6,5,2,4,2,1,50,0,0,50,1,51,89636.0496004721
"1544",1,6,0,0,0,7,7,1,1,2,1,4,0,0,0,0,4,4,539957.475859467
"1545",1,9,0,0,9,1,10,6,1,4,2,1,0,0,0,0,1,1,100161.274741001
"1546",3,0,0,0,0,3,3,3,2,2,2,11,60,60,0,0,11,71,408747.710379733
"1547",1,1,0,0,0,2,2,6,1,3,2,3,4,0,0,4,3,7,49937.3649234609
"1548",5,0,0,0,0,5,5,3,2,6,2,1,0,0,0,0,1,1,82900.2123399754
"1549",0,4,0,0,0,4,4,6,2,5,2,1,0,0,0,0,1,1,88126.2271873376
"1550",0,1,0,0,1,0,1,5,2,5,2,1,0,0,0,0,1,1,44534.3332698438
"1551",3,4,1,0,6,0,7,3,2,3,2,0,2,1,0,1,0,2,19192.2806134862
"1552",0,2,0,0,0,2,2,6,1,8,2,2,1,0,0,2,1,3,296044.177824523
"1553",1,0,0,0,0,1,1,6,2,2,2,1,1,0,0,1,1,2,79020.6303512265
"1554",1,0,0,0,0,1,1,6,1,3,2,1,3,3,0,0,1,4,5200.47426027187
"1555",3,6,0,7,0,2,9,3,2,6,4,2,3,0,0,1,4,5,42261.1271168116
"1556",5,3,0,0,4,4,8,2,2,6,2,5,4,0,0,0,9,9,81663.2109185602
"1557",1,0,0,0,0,1,1,6,1,8,2,1,0,0,0,0,1,1,61061.4532753843
"1558",1,0,0,0,0,1,1,6,1,4,2,1,0,0,0,0,1,1,20659.0551536729
"1559",3,0,0,0,0,3,3,4,1,8,2,3,3,0,0,3,3,6,29653.2211554246
"1560",3,0,2,0,0,1,3,2,2,4,2,1,1,0,0,1,1,2,26676.4763967414
"1561",2,10,11,0,0,1,12,5,2,6,2,1,16,9,0,7,1,17,14708.7957335689
"1562",1,3,0,0,1,3,4,1,1,6,1,1,0,0,0,0,1,1,168901.469368454
"1563",0,0,0,0,0,0,0,3,1,3,5,0,5,0,0,5,0,5,49434.955888638
"1564",0,7,4,0,0,3,7,4,2,7,2,4,3,0,0,2,5,7,24717.7249455113
"1565",3,4,0,0,7,0,7,5,2,3,5,0,5,0,0,3,2,5,12737.7727873496
"1566",1,2,0,0,2,1,3,5,1,2,2,3,4,0,0,5,2,7,12313.6485281027
"1567",0,0,0,0,0,0,0,1,1,5,2,1,6,0,0,6,1,7,40623.9656523442
"1568",2,2,0,0,0,4,4,2,2,8,4,0,10,10,0,0,0,10,185524.380521104
"1569",18,1,0,0,0,19,19,5,1,1,2,17,17,0,0,32,2,34,4948.95369877551
"1570",0,7,0,0,6,1,7,6,2,6,2,0,5,0,0,5,0,5,13848.5925214022
"1571",0,15,0,0,13,2,15,4,1,5,2,0,12,0,0,12,0,12,27782.7596808652
"1572",2,1,0,0,2,1,3,6,2,8,4,13,6,4,0,0,15,19,75787.4732183249
"1573",4,2,0,0,0,6,6,4,2,3,1,1,1,0,0,0,2,2,16497.3259531635
"1574",0,1,0,0,1,0,1,6,1,8,2,0,4,0,0,4,0,4,45351.1101436587
"1575",2,3,3,0,0,2,5,2,2,4,3,0,0,0,0,0,0,0,93421.7636905461
"1576",0,0,0,0,0,0,0,6,2,3,2,0,3,0,0,2,1,3,9377.25377278477
"1577",1,0,0,0,0,1,1,6,1,4,1,1,0,0,0,0,1,1,41175.1704299929
"1578",3,2,0,0,0,5,5,2,2,4,2,4,1,0,0,0,5,5,62500.9912746281
"1579",0,3,0,0,3,0,3,6,1,6,2,1,0,0,0,0,1,1,28381.1755292171
"1580",1,0,0,0,0,1,1,6,2,5,3,1,0,0,0,0,1,1,379249.604642023
"1581",5,0,0,0,1,4,5,3,2,5,4,3,0,0,0,0,3,3,56848.2008099746
"1582",0,12,12,0,0,0,12,2,1,5,1,0,16,16,0,0,0,16,153073.925433257
"1583",0,5,5,0,0,0,5,3,1,6,2,0,3,3,0,0,0,3,60090.9900266447
"1584",45,7,27,0,0,25,52,3,2,8,2,3,11,10,0,0,4,14,44500.3912133044
"1585",10,0,0,0,0,10,10,6,1,3,2,10,2,0,0,0,12,12,12850.5986878573
"1586",0,0,0,0,0,0,0,3,1,1,4,0,5,0,0,5,0,5,19269.8179309604
"1587",3,4,0,0,5,2,7,1,2,6,4,1,2,0,0,2,1,3,201323.316859902
"1588",1,2,0,0,0,3,3,3,2,5,4,45,0,0,0,0,45,45,62439.4871658416
"1589",4,21,21,0,1,3,25,1,2,4,1,3,9,8,0,1,3,12,142692.679045623
"1590",4,0,0,0,4,0,4,6,2,4,2,2,5,0,0,7,0,7,17494.6314621706
"1591",16,4,0,9,4,7,20,3,2,7,2,5,0,0,0,2,3,5,25940.8514282719
"1592",0,0,0,0,0,0,0,5,2,2,2,0,2,0,0,0,2,2,11659.026238889
"1593",3,0,0,0,0,3,3,3,2,7,2,0,0,0,0,0,0,0,80758.8442487858
"1594",2,1,0,0,1,2,3,5,2,8,4,1,1,0,0,1,1,2,80495.0005575579
"1595",2,2,0,0,2,2,4,4,1,1,2,2,0,0,0,0,2,2,7467.83780972448
"1596",7,14,0,0,8,13,21,1,2,4,2,17,32,38,0,0,11,49,60823.9703407541
"1597",1,0,0,0,0,1,1,5,1,8,2,0,1,0,0,1,0,1,12706.2287834178
"1598",0,0,0,0,0,0,0,6,2,6,2,0,1,0,0,0,1,1,46834.235313739
"1599",0,0,0,0,0,0,0,6,2,5,2,0,0,0,0,0,0,0,40652.3694772837
"1600",4,0,3,0,0,1,4,3,1,5,2,7,0,0,0,6,1,7,70339.2277653234
"1601",1,7,0,0,6,2,8,5,1,1,2,0,0,0,0,0,0,0,26251.3486562555
"1602",2,2,0,0,2,2,4,5,2,6,2,7,2,0,0,0,9,9,12238.5295387574
"1603",0,0,0,0,0,0,0,3,1,7,4,0,1,1,0,0,0,1,60351.7049741357
"1604",8,20,0,0,28,0,28,6,2,3,2,1,0,0,0,0,1,1,14979.0224460593
"1605",0,2,0,0,2,0,2,6,1,3,2,0,1,0,0,0,1,1,32918.0476941805
"1606",48,0,0,0,0,48,48,4,1,6,2,1,2,2,0,0,1,3,52865.586174872
"1607",0,3,2,0,0,1,3,5,1,4,2,0,0,0,0,0,0,0,10630.2632767798
"1608",3,0,2,0,0,1,3,4,2,6,4,3,0,0,0,0,3,3,277451.671527761
"1609",1,45,34,0,0,12,46,2,1,8,2,2,0,0,0,2,0,2,165550.27730073
"1610",0,20,20,0,0,0,20,1,1,5,2,0,20,20,0,0,0,20,90634.7149229453
"1611",1,0,0,0,0,1,1,5,2,6,2,2,4,0,0,5,1,6,77253.4373308705
"1612",0,0,0,0,0,0,0,2,1,1,2,0,0,0,0,0,0,0,9908.69913685429
"1613",2,1,1,0,0,2,3,4,1,5,3,2,9,9,0,0,2,11,539957.475859467
"1614",4,0,3,0,0,1,4,3,2,4,2,1,4,3,0,0,2,5,293245.190243012
"1615",15,66,0,11,70,0,81,1,1,2,2,0,3,0,0,2,1,3,261401.898455808
"1616",1,0,0,0,0,1,1,5,1,6,5,1,1,0,0,1,1,2,192023.223256634
"1617",17,61,75,0,0,3,78,4,2,4,1,4,4,4,0,2,2,8,213429.11154418
"1618",0,1,0,0,1,0,1,4,1,4,2,0,2,0,0,2,0,2,359373.189364526
"1619",0,1,0,0,0,1,1,6,2,3,2,6,0,0,0,4,2,6,14227.1877021583
"1620",2,0,0,0,0,2,2,4,2,7,2,1,2,2,0,0,1,3,194352.597500922
"1621",4,10,11,0,0,3,14,3,2,6,4,10,0,7,0,0,3,10,236042.54642611
"1622",0,1,0,0,1,0,1,6,2,2,2,0,3,0,0,3,0,3,41571.1028660544
"1623",3,1,0,0,2,2,4,6,2,6,2,3,4,0,0,5,2,7,172415.943693321
"1624",1,0,0,0,1,0,1,5,2,6,2,0,3,0,0,3,0,3,72186.930258199
"1625",3,1,0,0,0,4,4,3,1,3,2,3,4,0,0,1,6,7,14954.6017427554
"1626",0,0,0,0,0,0,0,3,1,4,4,0,0,0,0,0,0,0,101640.88783474
"1627",0,14,0,0,10,4,14,6,2,3,2,0,4,0,0,4,0,4,14227.1877021583
"1628",4,0,0,0,0,4,4,2,1,6,2,0,4,0,0,0,4,4,257714.061143739
"1629",3,71,70,0,2,2,74,1,2,3,2,3,4,0,0,5,2,7,79984.1839583588
"1630",1,5,4,0,0,2,6,5,1,5,5,19,36,53,0,0,2,55,191921.873031704
"1631",2,1,0,0,1,2,3,5,1,6,2,2,2,0,0,2,2,4,14177.8754079192
"1632",1,0,0,0,0,1,1,2,2,3,2,1,0,0,0,0,1,1,115856.14529606
"1633",5,0,0,0,0,5,5,4,1,4,2,5,0,0,0,4,1,5,41061.2905393223
"1634",3,6,0,0,6,3,9,3,2,7,2,4,3,0,0,1,6,7,345808.76929066
"1635",27,44,62,0,4,5,71,3,2,6,2,12,0,0,0,7,5,12,44596.9644283633
"1636",0,0,0,0,0,0,0,6,2,2,2,1,0,0,0,0,1,1,47440.7339488331
"1637",2,7,0,0,7,2,9,6,1,6,2,1,4,0,0,4,1,5,72413.0908755376
"1638",0,6,1,5,0,0,6,2,2,4,1,1,2,0,0,3,0,3,74093.0063388652
"1639",3,0,0,0,0,3,3,6,2,4,3,0,0,0,0,0,0,0,88008.1386959027
"1640",3,11,0,0,12,2,14,2,2,5,2,1,0,0,0,0,1,1,38098.574535483
"1641",0,2,0,0,2,0,2,6,2,6,3,0,3,0,0,0,3,3,162464.287916157
"1642",2,4,4,0,0,2,6,4,2,6,3,1,116,0,0,116,1,117,183317.930491056
"1643",0,7,5,0,0,2,7,3,1,4,4,1,0,1,0,0,0,1,539957.475859467
"1644",0,1,0,0,1,0,1,2,1,5,2,0,2,0,0,2,0,2,48402.7203374176
"1645",0,1,0,0,1,0,1,2,2,5,2,0,0,0,0,0,0,0,53600.4473067119
"1646",2,6,0,0,6,2,8,2,1,8,2,3,1,0,0,0,4,4,180761.841450051
"1647",1,2,0,0,0,3,3,5,1,8,3,1,1,0,0,0,2,2,228031.135653688
"1648",0,0,0,0,0,0,0,5,1,3,2,0,3,0,0,3,0,3,67015.0433152427
"1649",0,1,0,0,0,1,1,3,2,6,2,5,160,0,0,165,0,165,29722.8474745916
"1650",0,1,0,0,0,1,1,6,2,3,2,1,1,0,0,0,2,2,38425.2988528111
"1651",0,2,2,0,0,0,2,3,2,4,3,3,2,3,0,0,2,5,228807.84163726
"1652",4,0,0,0,0,4,4,4,2,7,2,2,2,4,0,0,0,4,71629.4497475035
"1653",3,4,0,0,5,2,7,1,2,3,2,1,3,0,0,3,1,4,29478.5002058599
"1654",2,0,0,0,0,2,2,4,1,5,2,2,3,0,0,3,2,5,52964.1341957414
"1655",10,0,10,0,0,0,10,2,1,4,2,5,30,33,0,2,0,35,152841.107684317
"1656",0,0,0,0,0,0,0,5,1,5,2,0,1,0,0,1,0,1,45274.7404049103
"1657",0,3,0,0,3,0,3,6,2,6,2,0,4,0,0,4,0,4,43574.6800861864
"1658",9,0,0,0,0,9,9,2,1,6,1,37,47,30,0,29,25,84,44764.1979760707
"1659",5,0,0,0,0,5,5,1,2,1,3,23,0,10,0,4,9,23,375772.302852339
"1660",4,4,0,0,4,4,8,2,2,4,4,0,0,0,0,0,0,0,289556.040281441
"1661",4,4,0,0,0,8,8,2,2,6,2,1,2,0,0,1,2,3,91628.8418253822
"1662",0,0,0,0,0,0,0,6,2,4,3,0,0,0,0,0,0,0,60532.0101954275
"1663",9,10,0,0,16,3,19,4,2,6,3,2,3,0,0,5,0,5,117238.562449839
"1664",2,3,0,3,0,2,5,3,2,6,4,3,4,0,0,4,3,7,30297.1709289129
"1665",6,13,17,0,0,2,19,1,1,1,2,2,6,6,1,0,1,8,21608.4427399316
"1666",4,6,0,2,8,0,10,6,2,4,2,1,0,0,0,0,1,1,73919.1942850815
"1667",0,0,0,0,0,0,0,5,2,3,3,46,0,0,0,0,46,46,196061.443003102
"1668",0,0,0,0,0,0,0,6,2,6,2,0,1,0,0,1,0,1,29646.4884529794
"1669",1,2,1,0,1,1,3,2,2,4,2,6,7,0,0,6,7,13,70465.2912136027
"1670",0,1,0,0,1,0,1,6,1,2,2,9,8,0,0,17,0,17,223324.493234078
"1671",0,0,0,0,0,0,0,5,2,5,3,0,0,0,0,0,0,0,70058.9062601648
"1672",1,2,0,0,0,3,3,3,2,3,2,1,1,0,0,0,2,2,25760.8375775305
"1673",5,4,0,0,0,9,9,2,2,1,3,61,40,30,0,40,31,101,289403.198918868
"1674",0,1,0,0,1,0,1,6,1,4,2,0,3,0,0,3,0,3,21184.8704514234
"1675",5,0,0,0,2,3,5,2,2,3,2,4,0,0,0,0,4,4,65914.2134368967
"1676",1,0,0,0,0,1,1,5,1,6,2,1,0,0,0,0,1,1,20250.9219474883
"1677",0,23,0,0,23,0,23,3,2,2,2,1,4,0,0,4,1,5,9528.13731870313
"1678",1,0,0,0,0,1,1,2,2,3,3,2,96,70,7,20,1,98,202465.912086419
"1679",13,5,0,0,18,0,18,3,2,3,3,15,3,18,0,0,0,18,112148.471878709
"1680",1,0,0,0,0,1,1,6,1,5,2,1,2,0,0,1,2,3,103376.410328667
"1681",0,1,0,0,0,1,1,6,2,8,2,1,0,0,0,0,1,1,102528.458186345
"1682",1,0,0,0,0,1,1,6,2,4,3,3,0,0,0,0,3,3,95805.2051129859
"1683",1,0,0,0,0,1,1,3,2,4,2,1,0,0,0,0,1,1,29997.7520582276
"1684",1,2,0,0,2,1,3,4,2,6,3,1,6,5,0,0,2,7,281077.522153374
"1685",0,2,0,0,1,1,2,5,2,3,3,1,0,0,0,0,1,1,145103.422532613
"1686",1,3,0,0,0,4,4,5,2,2,3,3,2,0,0,0,5,5,89241.8074065366
"1687",0,4,0,0,2,2,4,6,1,8,3,0,1,0,0,1,0,1,180201.260418969
"1688",4,8,8,0,4,0,12,6,2,8,3,1,2,0,0,3,0,3,539957.475859467
"1689",0,3,0,0,3,0,3,1,2,3,2,6,107,101,0,2,10,113,45480.2594569777
"1690",5,2,0,0,4,3,7,1,2,1,3,2,3,3,0,0,2,5,359090.430953317
"1691",1,20,20,0,0,1,21,4,1,4,2,1,15,13,0,0,3,16,76499.3888011629
"1692",0,2,0,0,2,0,2,5,2,2,3,0,8,0,0,8,0,8,110592.502905929
"1693",1,1,0,0,1,1,2,6,2,3,2,0,0,0,0,0,0,0,13413.1574834369
"1694",1,9,7,0,2,1,10,4,1,7,2,1,8,5,0,0,4,9,70509.4371668281
"1695",46,0,0,0,40,6,46,5,2,5,3,3,0,0,0,0,3,3,87172.404689727
"1696",15,0,0,0,12,3,15,3,1,8,2,6,0,3,0,0,3,6,58925.2621758291
"1697",0,5,0,0,4,1,5,6,2,6,2,1,5,0,0,2,4,6,24709.4864960125
"1698",0,1,0,0,0,1,1,6,1,7,2,1,1,0,0,1,1,2,14689.0241958419
"1699",0,5,5,0,0,0,5,3,1,3,2,0,21,20,0,0,1,21,86069.1501000541
"1700",0,0,0,0,0,0,0,2,2,3,2,4,0,0,0,0,4,4,260266.47874286
"1701",29,106,131,0,0,4,135,2,2,3,5,0,13,0,0,10,3,13,539957.475859467
"1702",2,0,0,0,0,2,2,4,2,5,2,6,2,0,0,6,2,8,34263.0170729304
"1703",3,10,10,0,0,3,13,2,2,2,1,1,3,0,0,0,4,4,146768.756721998
"1704",4,0,0,0,4,0,4,2,2,6,1,10,3,0,0,13,0,13,107218.400251037
"1705",0,1,0,0,1,0,1,5,2,2,2,0,5,5,0,0,0,5,19591.1810810956
"1706",10,14,16,0,4,4,24,3,1,3,1,0,24,8,0,12,4,24,139073.104676412
"1707",1,1,0,0,2,0,2,6,1,5,2,2,0,0,0,0,2,2,29287.3596112103
"1708",0,0,0,0,0,0,0,6,1,3,2,0,0,0,0,0,0,0,77728.5083144617
"1709",3,1,0,0,3,1,4,3,2,8,2,0,3,0,0,0,3,3,143359.891550016
"1710",2,0,0,0,1,1,2,2,1,5,1,6,0,0,0,5,1,6,241226.443119258
"1711",1,2,0,0,2,1,3,1,2,2,2,1,0,0,0,0,1,1,40362.5451929242
"1712",0,0,0,0,0,0,0,5,1,5,1,0,8,8,0,0,0,8,452880.110552938
"1713",0,1,0,0,1,0,1,4,2,3,4,2,1,0,0,1,2,3,40496.2248247435
"1714",3,18,17,0,0,4,21,4,1,8,1,2,1,0,0,1,2,3,99043.2983087978
"1715",8,24,17,0,15,0,32,6,1,3,2,2,14,16,0,0,0,16,36461.4219921737
"1716",19,0,0,0,18,1,19,1,2,2,2,10,0,0,0,7,3,10,35579.9694181715
"1717",2,3,0,0,3,2,5,2,2,2,2,0,4,0,0,2,2,4,374034.69633982
"1718",0,0,0,0,0,0,0,2,1,3,1,0,4,4,0,0,0,4,118955.44855957
"1719",0,3,2,0,1,0,3,1,1,5,1,3,0,0,0,0,3,3,60419.6836516402
"1720",1,14,0,0,14,1,15,2,2,3,1,4,0,0,0,0,4,4,27764.0953935049
"1721",5,3,0,0,3,5,8,4,1,3,1,10,5,5,0,0,10,15,158941.745802451
"1722",1,2,0,0,0,3,3,3,1,4,2,3,2,0,0,4,1,5,64093.2558872513
"1723",1,0,0,0,0,1,1,2,2,6,1,1,0,0,0,0,1,1,119559.532760532
"1724",2,1,1,0,0,2,3,5,2,4,1,0,0,0,0,0,0,0,119700.253177863
"1725",3,0,0,0,0,3,3,6,2,4,1,3,0,0,0,0,3,3,30399.8620219458
"1726",3,3,2,0,0,4,6,3,2,3,1,3,3,3,0,0,3,6,129146.766226219
"1727",2,2,0,0,4,0,4,6,2,3,2,0,2,0,0,1,1,2,14365.0060142534
"1728",3,6,6,0,0,3,9,4,1,8,1,6,0,0,0,2,4,6,50226.7529601435
"1729",9,14,14,0,6,3,23,3,2,1,1,3,0,0,0,0,3,3,170363.819019432
"1730",15,30,44,0,0,1,45,3,2,6,4,36,0,35,0,0,1,36,256184.803994056
"1731",3,0,0,0,0,3,3,3,1,5,1,3,8,8,0,0,3,11,52151.7272749041
"1732",4,33,33,0,0,4,37,3,2,8,2,4,0,0,0,0,4,4,88156.5107469076
"1733",11,0,10,0,0,1,11,5,1,3,1,2,10,9,0,2,1,12,58808.7957791945
"1734",2,6,0,0,8,0,8,6,1,8,1,4,0,0,0,0,4,4,351384.336264861
"1735",8,21,17,0,7,5,29,6,2,3,2,3,2,0,0,3,2,5,183458.519517914
"1736",2,0,0,0,1,1,2,4,2,6,2,3,0,0,0,0,3,3,81082.7172704461
"1737",3,0,0,0,0,3,3,1,2,2,1,0,0,0,0,0,0,0,143042.645966357
"1738",5,2,0,0,2,5,7,1,2,3,1,5,0,0,0,0,5,5,492769.089952647
"1739",0,1,0,0,1,0,1,4,2,2,1,0,2,0,0,2,0,2,47667.8929756754
"1740",12,10,20,0,0,2,22,3,2,3,2,6,2,4,0,0,4,8,56786.8221974686
"1741",0,2,1,0,0,1,2,5,1,7,1,6,13,0,0,17,2,19,121384.23924852
"1742",17,16,27,0,5,1,33,4,2,2,1,14,21,14,0,21,0,35,65125.245004668
"1743",5,0,2,0,0,3,5,4,1,3,1,19,17,16,3,8,9,36,539957.475859467
"1744",1,2,0,0,2,1,3,2,1,5,1,1,1,0,0,0,2,2,176596.852568424
"1745",3,5,0,0,8,0,8,2,2,2,1,2,1,0,0,1,2,3,312773.302760938
"1746",2,1,0,0,0,3,3,3,2,5,1,3,8,0,0,8,3,11,69832.3021999481
"1747",1,0,0,0,0,1,1,5,2,4,5,0,2,0,0,0,2,2,138375.057390685
"1748",3,0,0,0,3,0,3,2,2,2,1,8,0,4,0,4,0,8,133911.508591687
"1749",0,3,0,0,2,1,3,6,2,5,1,0,0,0,0,0,0,0,39658.8905958178
"1750",15,0,0,0,11,4,15,3,2,6,1,70,40,30,40,30,10,110,91289.548486929
"1751",0,0,0,0,0,0,0,1,2,1,1,6,0,5,0,0,1,6,50101.0303913127
"1752",0,3,0,0,3,0,3,5,1,5,1,0,0,0,0,0,0,0,539957.475859467
"1753",1,1,0,0,2,0,2,6,1,3,1,0,1,0,0,1,0,1,112492.634082834
"1754",6,14,0,0,16,4,20,5,1,8,2,7,2,0,0,0,9,9,539957.475859467
"1755",7,5,0,0,8,4,12,2,2,2,2,4,0,0,0,0,4,4,134722.794986247
"1756",20,0,0,0,0,20,20,1,2,4,1,3,1,0,0,0,4,4,216000.133198026
"1757",0,1,0,0,1,0,1,6,1,1,1,0,1,0,0,1,0,1,22371.9529024775
"1758",0,3,0,0,1,2,3,4,2,6,1,1,0,0,0,0,1,1,539957.475859467
"1759",5,4,0,0,4,5,9,6,1,6,1,1,5,0,0,5,1,6,37718.8000046503
"1760",1,1,0,0,1,1,2,2,2,4,1,4,1,0,0,0,5,5,82065.1207500308
"1761",2,2,0,0,0,4,4,5,2,3,1,2,6,0,0,3,5,8,228525.569280158
"1762",41,40,63,0,17,1,81,1,1,3,3,26,50,65,0,10,1,76,539957.475859467
"1763",0,1,0,0,0,1,1,5,2,4,2,0,2,0,0,2,0,2,73749.1279871914
"1764",20,11,20,0,0,11,31,4,2,7,1,3,0,0,0,0,3,3,124320.091990245
"1765",950,842,850,850,92,0,1792,4,2,3,1,0,25,25,0,0,0,25,86382.8987051826
"1766",1,2,0,0,0,3,3,4,1,4,2,2,5,4,0,1,2,7,158028.16397692
"1767",0,3,0,0,3,0,3,4,2,2,2,0,1,0,0,0,1,1,48287.8757406008
"1768",2,6,0,6,1,1,8,1,2,3,1,1,15,15,0,0,1,16,122879.58890196
"1769",0,7,0,0,7,0,7,6,2,5,3,2,3,0,0,5,0,5,137408.786917232
"1770",2,0,0,0,0,2,2,4,2,4,2,2,0,0,0,0,2,2,67500.9128863269
"1771",1,12,0,0,12,1,13,4,2,2,2,0,0,0,0,0,0,0,123887.557666575
"1772",0,6,6,0,0,0,6,2,1,4,1,3,14,0,0,17,0,17,135546.183392898
"1773",73,53,102,0,20,4,126,4,1,7,4,26,0,25,0,0,1,26,229051.534460873
"1774",4,0,0,0,3,1,4,2,2,2,1,7,4,9,0,1,1,11,22671.2373246036
"1775",1,2,0,0,1,2,3,3,2,6,1,0,3,0,0,0,3,3,89124.4402675524
"1776",3,1,0,0,1,3,4,5,2,8,2,3,0,0,0,0,3,3,34337.7081649379
"1777",0,0,0,0,0,0,0,4,2,4,1,1,0,0,0,0,1,1,19397.7011631614
"1778",3,1,0,0,1,3,4,1,2,5,1,2,0,0,0,0,2,2,75608.3123777233
"1779",0,0,0,0,0,0,0,3,2,1,1,1,6,0,0,6,1,7,31201.2789660158
"1780",15,17,28,0,0,4,32,5,2,5,1,0,3,0,0,3,0,3,12372.9644258428
"1781",2,1,0,0,0,3,3,6,2,3,2,2,0,0,0,2,0,2,76829.5286465842
"1782",4,4,4,0,0,4,8,3,1,3,1,15,8,8,0,10,5,23,164674.641934364
"1783",0,0,0,0,0,0,0,4,2,8,2,0,0,0,0,0,0,0,53461.7221443649
"1784",1,3,0,0,2,2,4,5,1,5,1,1,2,0,0,0,3,3,69665.3675738707
"1785",1,4,0,0,1,4,5,5,2,3,1,0,0,0,0,0,0,0,45202.5037233389
"1786",3,27,28,0,0,2,30,4,2,3,2,1,4,0,0,4,1,5,9274.68306941767
"1787",1,0,0,0,0,1,1,6,2,2,1,1,0,0,0,0,1,1,94794.5479881445
"1788",1,0,0,0,0,1,1,6,2,4,1,2,0,0,0,0,2,2,22720.6278701014
"1789",1,1,0,0,1,1,2,4,2,4,4,0,0,0,0,0,0,0,38364.0091511421
"1790",3,1,0,0,3,1,4,5,2,8,2,1,0,0,0,0,1,1,33742.8500602918
"1791",0,0,0,0,0,0,0,6,2,4,4,0,0,0,0,0,0,0,22964.6386060526
"1792",0,0,0,0,0,0,0,5,1,3,1,0,0,0,0,0,0,0,31560.160008484
"1793",0,3,0,0,0,3,3,1,1,3,1,2,0,0,0,0,2,2,70538.0271616935
"1794",12,17,0,0,27,2,29,2,2,3,4,12,27,20,0,7,12,39,211268.522915087
"1795",0,2,0,0,2,0,2,6,2,4,1,0,2,0,0,1,1,2,45487.8059670973
"1796",7,2,0,0,2,7,9,3,2,1,1,6,7,0,0,12,1,13,24800.6737408319
"1797",2,10,9,0,3,0,12,5,2,3,1,0,8,8,0,0,0,8,161998.746804279
"1798",0,50,50,0,0,0,50,6,2,2,2,6,1,0,0,0,7,7,44543.6123025324
"1799",3,14,0,0,14,3,17,4,1,8,2,3,12,0,0,10,5,15,47583.8828834735
"1800",2,0,0,0,0,2,2,5,2,5,2,1,0,0,0,0,1,1,37378.1201769762
"1801",2,0,0,0,1,1,2,4,2,7,1,2,0,0,0,0,2,2,293431.792193728
"1802",6,0,4,0,0,2,6,2,2,4,2,6,13,14,0,3,2,19,36255.1639448889
"1803",0,3,0,0,3,0,3,6,2,2,2,1,3,0,0,4,0,4,7577.06664011618
"1804",0,0,0,0,0,0,0,6,2,2,5,0,0,0,0,0,0,0,27349.5365004415
"1805",4,1,4,0,1,0,5,5,2,2,2,1,0,0,0,1,0,1,5788.90078791187
"1806",4,2,0,0,4,2,6,5,2,6,2,2,6,0,0,6,2,8,24680.6956834492
"1807",5,0,0,0,0,5,5,2,2,5,2,4,0,0,0,0,4,4,27638.7295259569
"1808",3,1,0,0,1,3,4,6,1,8,2,2,2,0,0,2,2,4,16623.443645073
"1809",9,0,0,0,0,9,9,6,2,3,2,2,10,0,0,10,2,12,39761.4918001739
"1810",0,2,0,0,1,1,2,3,1,5,2,1,0,0,0,0,1,1,17968.1053217331
"1811",14,6,2,4,1,13,20,2,2,3,1,2,1,1,0,1,1,3,85548.2454281531
"1812",5,3,0,0,3,5,8,3,2,5,1,2,0,0,0,0,2,2,44054.0366624958
"1813",4,2,0,0,5,1,6,2,1,6,3,0,2,0,0,0,2,2,111161.878197231
"1814",1,2,1,0,1,1,3,4,1,5,2,1,0,0,0,0,1,1,15786.2280546943
"1815",0,1,0,0,0,1,1,3,1,6,1,0,1,0,0,0,1,1,19790.7743564104
"1816",1,3,3,0,0,1,4,2,1,7,2,1,2,2,0,0,1,3,87722.6029438326
"1817",2,1,3,0,0,0,3,2,2,4,2,6,20,8,0,15,3,26,27907.0770236197
"1818",2,0,0,0,0,2,2,6,2,5,2,2,2,0,0,2,2,4,70468.1109625433
"1819",2,2,0,0,2,2,4,5,2,6,2,3,0,0,0,0,3,3,12584.2333921844
"1820",4,0,0,0,0,4,4,4,1,6,2,6,2,0,0,2,6,8,67067.146302201
"1821",0,0,0,0,0,0,0,6,2,2,4,3,0,0,0,3,0,3,24768.5641878216
"1822",0,1,0,0,0,1,1,6,1,6,2,1,0,0,0,0,1,1,30294.7347597313
"1823",1,0,0,0,0,1,1,6,2,3,2,1,1,0,0,1,1,2,47286.7573891885
"1824",20,31,41,0,0,10,51,5,1,8,2,13,87,99,0,0,1,100,12761.3900036083
"1825",2,0,2,0,0,0,2,6,2,6,2,4,0,0,0,0,4,4,90523.9791959677
"1826",2,4,0,0,0,6,6,5,2,3,2,3,3,0,0,0,6,6,5365.55028540108
"1827",0,1,0,0,1,0,1,6,2,2,2,5,0,0,0,0,5,5,39439.1498285251
"1828",1,10,0,0,4,7,11,1,2,3,2,1,70,70,0,0,1,71,11602.1741189665
"1829",5,0,0,0,0,5,5,3,1,6,2,7,0,0,0,3,4,7,48939.5987831075
"1830",2,9,6,0,2,3,11,4,2,5,2,10,58,53,0,10,5,68,36726.3498049711
"1831",2,0,0,0,0,2,2,5,1,4,2,1,2,0,0,0,3,3,14056.0653072947
"1832",4,2,0,0,2,4,6,6,1,8,2,1,4,0,0,4,1,5,16047.0171847765
"1833",5,1,0,0,4,2,6,3,2,3,4,1,1,0,0,2,0,2,23968.4936265812
"1834",4,112,113,0,0,3,116,1,2,4,2,1,131,110,0,21,1,132,38129.0231779503
"1835",0,4,0,0,0,4,4,2,2,3,2,3,8,5,0,0,6,11,31537.3700635773
"1836",0,4,0,0,2,2,4,6,2,3,2,2,2,1,0,1,2,4,17049.8706044921
"1837",2,3,0,0,3,2,5,4,2,4,2,1,1,0,0,1,1,2,11846.1264194862
"1838",6,12,15,0,0,3,18,4,2,7,4,5,15,17,0,0,3,20,22440.7242590027
"1839",8,91,90,0,3,6,99,1,2,2,5,30,623,637,0,0,16,653,225656.47406383
"1840",1,0,0,0,0,1,1,5,2,1,2,12,2,0,0,12,2,14,4624.69733907441
"1841",2,10,10,0,0,2,12,3,2,6,2,2,2,2,0,0,2,4,37981.3662293488
"1842",2,9,10,0,0,1,11,5,2,5,2,0,0,0,0,0,0,0,19867.1512686106
"1843",0,0,0,0,0,0,0,5,1,5,2,0,3,1,0,2,0,3,19653.0822002895
"1844",1,0,0,0,0,1,1,6,2,6,3,1,4,0,0,5,0,5,60782.3234163396
"1845",0,1,0,0,0,1,1,6,2,6,2,0,1,0,0,1,0,1,8993.17880309541
"1846",1,0,0,0,0,1,1,6,2,8,2,7,6,0,0,12,1,13,275365.039601643
"1847",0,3,2,0,1,0,3,5,2,4,2,0,21,11,0,10,0,21,14609.0489113348
"1848",4,0,0,0,2,2,4,5,1,5,2,1,0,0,0,0,1,1,4360.83109507747
"1849",1,3,0,0,0,4,4,6,1,8,2,1,6,6,0,0,1,7,39652.8792679637
"1850",4,6,4,0,0,6,10,4,1,8,2,20,12,26,0,0,6,32,388819.30825973
"1851",1,21,20,0,0,2,22,4,2,7,2,1,4,0,0,4,1,5,34027.8286031252
"1852",0,15,0,0,12,3,15,4,1,4,2,0,11,0,0,10,1,11,27257.4465938338
"1853",0,11,0,0,11,0,11,6,2,3,2,0,1,0,0,0,1,1,12116.6997228559
"1854",142,163,195,0,99,11,305,5,1,8,2,0,44,40,0,4,0,44,12761.3900036083
"1855",1,0,0,0,0,1,1,6,1,4,2,0,0,0,0,0,0,0,22051.9617174731
"1856",1,0,0,0,0,1,1,6,2,4,2,1,0,0,0,0,1,1,19867.6369786176
"1857",0,3,0,0,0,3,3,1,2,4,1,1,0,0,0,1,0,1,288219.918857074
"1858",1,6,0,0,5,2,7,4,2,5,2,13,8,8,0,0,13,21,25143.8284394282
"1859",7,8,13,0,0,2,15,5,1,8,2,10,12,14,0,6,2,22,41545.16112246
"1860",0,0,0,0,0,0,0,6,2,3,4,0,0,0,0,0,0,0,16344.0515029561
"1861",0,5,0,0,4,1,5,5,1,5,5,0,9,0,0,8,1,9,34964.4008385216
"1862",2,6,6,0,0,2,8,4,2,6,2,2,11,11,0,0,2,13,18097.6286757351
"1863",0,7,6,0,0,1,7,2,2,5,4,0,14,10,0,3,1,14,51545.1462456094
"1864",1,0,0,0,0,1,1,2,1,1,1,6,0,0,0,0,6,6,36125.0744493402
"1865",4,5,0,0,1,8,9,3,2,6,2,3,10,0,0,0,13,13,50039.4628229187
"1866",0,0,0,0,0,0,0,6,2,3,2,0,0,0,0,0,0,0,12116.6997228559
"1867",3,1,0,0,0,4,4,4,1,7,2,3,3,0,0,0,6,6,43410.371390913
"1868",0,5,0,0,5,0,5,4,1,7,4,0,0,0,0,0,0,0,270880.429039669
"1869",0,0,0,0,0,0,0,3,1,8,2,0,0,0,0,0,0,0,33976.0820905787
"1870",2,1,0,0,1,2,3,6,2,6,2,0,0,0,0,0,0,0,14470.6927398731
"1871",1,3,0,0,3,1,4,6,2,6,2,1,1,0,0,0,2,2,17391.5063047389
"1872",3,2,0,0,0,5,5,3,2,8,2,2,1,0,0,1,2,3,46499.4176885979
"1873",0,0,0,0,0,0,0,6,2,5,2,0,2,0,0,2,0,2,9372.82350468581
"1874",3,1,0,0,0,4,4,4,1,8,2,2,5,0,0,5,2,7,47583.8828834735
"1875",2,1,0,0,0,3,3,6,2,7,2,3,2,0,0,5,0,5,24770.1254964461
"1876",10,9,0,0,9,10,19,3,1,2,1,8,4,0,0,5,7,12,49108.4321770251
"1877",1,6,0,0,6,1,7,6,2,5,2,1,1,0,0,1,1,2,7000.71215860504
"1878",0,0,0,0,0,0,0,2,1,4,4,3,5,0,0,8,0,8,184312.062561892
"1879",0,3,0,0,1,2,3,6,1,3,2,0,0,0,0,0,0,0,8595.74933400451
"1880",1,3,0,0,3,1,4,5,2,5,2,2,9,10,0,0,1,11,13310.27518635
"1881",0,2,0,1,0,1,2,1,1,4,2,4,3,0,0,6,1,7,385134.080160887
"1882",0,0,0,0,0,0,0,4,2,6,2,2,4,0,0,5,1,6,9405.23814361404
"1883",5,9,0,0,9,5,14,3,2,4,1,4,1,0,0,1,4,5,81479.6181144637
"1884",3,0,0,0,0,3,3,4,2,6,2,3,1,0,0,1,3,4,23891.4895999511
"1885",7,0,0,0,0,7,7,6,1,7,2,1,12,0,0,12,1,13,23321.3909974487
"1886",1,1,0,0,2,0,2,6,1,2,2,1,2,0,0,1,2,3,1545.18573567931
"1887",2,4,0,0,5,1,6,3,1,8,2,1,0,0,0,1,0,1,19177.7997207483
"1888",1,5,0,0,2,4,6,6,1,8,2,1,3,0,0,0,4,4,16047.0171847765
"1889",10,6,0,1,11,4,16,3,2,8,2,4,3,0,0,3,4,7,46499.4176885979
"1890",1,0,0,0,0,1,1,5,2,4,5,1,0,0,0,0,1,1,24905.7088434955
"1891",1,2,1,0,1,1,3,2,1,7,2,1,3,2,0,1,1,4,30617.0227685763
"1892",0,2,0,0,1,1,2,6,1,8,4,0,1,0,0,0,1,1,39961.2517506291
"1893",0,0,0,0,0,0,0,6,2,3,2,0,0,0,0,0,0,0,3773.24123509359
"1894",0,0,0,0,0,0,0,5,1,5,2,1,6,0,0,5,2,7,10461.570498928
"1895",1,1,0,0,1,1,2,5,1,4,4,1,1,0,0,1,1,2,10379.0926405681
"1896",4,0,0,0,1,3,4,5,2,2,2,3,4,0,0,6,1,7,5547.54887465652
"1897",2,4,0,0,4,2,6,5,2,8,2,1,0,0,0,0,1,1,23337.5531016173
"1898",11,0,1,5,0,5,11,1,2,2,2,7,1,0,0,3,5,8,26343.3543933118
"1899",2,1,0,0,1,2,3,2,2,6,2,6,0,0,0,0,6,6,39023.6674859712
"1900",4,21,12,0,7,6,25,2,1,6,2,1,4,0,0,1,4,5,65593.2274539803
"1901",5,2,0,0,0,7,7,5,1,8,2,6,9,0,0,14,1,15,12761.3900036083
"1902",1,0,0,0,0,1,1,6,1,7,4,1,0,0,0,0,1,1,83945.9525784155
"1903",1,8,0,0,9,0,9,6,2,5,2,2,2,0,0,4,0,4,5842.34151241116
"1904",18,20,28,0,0,10,38,4,1,6,2,0,5,5,0,0,0,5,8950.40549272915
"1905",2,1,0,0,1,2,3,4,1,5,2,2,3,0,0,3,2,5,15786.2280546943
"1906",0,6,6,0,0,0,6,6,2,3,4,0,0,0,0,0,0,0,85071.9053488928
"1907",0,2,0,0,2,0,2,6,2,7,2,1,2,0,0,2,1,3,12808.6758939307
"1908",1,5,0,0,5,1,6,6,1,6,2,0,4,0,0,4,0,4,7458.60419318096
"1909",5,0,4,0,0,1,5,3,1,7,2,6,0,4,0,0,2,6,40286.4924242756
"1910",3,0,0,0,0,3,3,5,2,7,4,0,2,0,0,0,2,2,53516.9646355107
"1911",3,3,3,0,0,3,6,3,2,7,2,3,2,0,0,2,3,5,24738.8516495343
"1912",1,0,0,0,0,1,1,5,1,3,2,0,0,0,0,0,0,0,18001.8436946018
"1913",2,6,0,0,4,4,8,4,2,8,2,7,14,12,0,8,1,21,44306.9426511021
"1914",6,2,0,0,8,0,8,6,2,6,2,4,0,0,0,4,0,4,17356.3220378291
"1915",4,2,0,0,2,4,6,6,2,4,4,1,2,0,0,1,2,3,15814.5731886517
"1916",2,0,0,0,0,2,2,6,1,6,2,0,2,0,0,1,1,2,8524.36745093736
"1917",0,7,0,0,7,0,7,5,2,7,3,9,9,0,0,18,0,18,49254.1119067124
"1918",3,1,0,0,1,3,4,3,1,6,2,3,2,0,0,2,3,5,13377.3846885494
"1919",0,1,0,0,1,0,1,2,1,5,4,0,0,0,0,0,0,0,85622.2195814069
"1920",5,12,13,0,0,4,17,3,1,6,4,2,2,0,0,2,2,4,21427.9246411561
"1921",2,1,0,0,1,2,3,3,2,8,2,2,3,0,0,3,2,5,74669.648911054
"1922",8,5,0,0,0,13,13,5,2,6,4,2,0,0,0,0,2,2,46984.0787656606
"1923",1,10,7,0,3,1,11,6,1,4,4,1,3,3,0,0,1,4,13051.3586622218
"1924",0,1,0,0,0,1,1,6,2,6,2,0,2,0,0,0,2,2,14408.3292858745
"1925",0,2,0,0,0,2,2,6,1,6,4,2,0,0,0,1,1,2,17929.8084221161
"1926",0,0,0,0,0,0,0,4,1,1,2,0,0,0,0,0,0,0,3493.04808309096
"1927",0,455,455,0,0,0,455,2,1,4,2,0,115,115,0,0,0,115,23432.7522280363
"1928",1,3,0,0,4,0,4,2,2,6,2,0,4,0,0,4,0,4,14276.957477286
"1929",4,0,0,0,1,3,4,3,2,8,3,3,1,0,0,1,3,4,100997.708147059
"1930",0,3,0,0,3,0,3,3,1,2,4,0,0,0,0,0,0,0,18030.7101973751
"1931",2,2,0,1,0,3,4,4,2,8,4,2,0,0,0,0,2,2,61676.0950470749
"1932",0,0,0,0,0,0,0,6,2,4,2,0,2,0,0,0,2,2,9452.88801713745
"1933",1,0,0,0,0,1,1,5,2,8,4,1,0,0,0,0,1,1,83940.7980996302
"1934",0,6,3,0,3,0,6,3,2,8,4,0,0,0,0,0,0,0,86742.8952509094
"1935",11,29,38,0,0,2,40,5,2,8,2,1,2,0,0,2,1,3,38900.7604178733
"1936",3,0,0,0,0,3,3,3,1,8,2,3,0,0,0,0,3,3,18512.7996494434
"1937",2,2,0,1,1,2,4,3,2,8,1,4,1,0,2,1,2,5,61065.9678948005
"1938",5,0,0,0,0,5,5,6,2,5,2,16,8,0,0,8,16,24,12295.2339948575
"1939",3,0,2,0,0,1,3,5,1,5,2,1,0,0,0,0,1,1,4385.74274651454
"1940",0,2,0,0,2,0,2,1,2,6,4,1,0,0,0,0,1,1,83332.3260082187
"1941",3,1,0,0,2,2,4,5,2,5,2,2,0,0,0,0,2,2,5332.66898386094
"1942",1,2,0,0,1,2,3,5,1,7,2,1,18,0,0,19,0,19,28604.7480540843
"1943",2,0,0,0,0,2,2,1,1,4,2,4,8,0,0,8,4,12,63562.1603863695
"1944",1,0,0,0,0,1,1,5,1,4,4,1,1,0,0,1,1,2,26568.4657615541
"1945",1,11,0,0,8,4,12,6,1,2,4,1,16,9,0,6,2,17,5951.12641287251
"1946",0,0,0,0,0,0,0,6,2,5,2,0,0,0,0,0,0,0,5842.34151241116
"1947",3,2,0,0,4,1,5,5,2,8,2,1,1,0,0,2,0,2,58834.6549789034
"1948",3,1,0,0,0,4,4,3,2,3,1,0,9,0,0,8,1,9,29508.0083838379
"1949",5,4,6,0,0,3,9,3,2,2,3,2,0,0,0,0,2,2,67913.4901666919
"1950",2,3,0,0,4,1,5,3,2,4,1,1,13,11,0,0,3,14,25547.5507094622
"1951",1,9,7,0,2,1,10,5,2,8,2,1,8,0,0,9,0,9,23438.5648421472
"1952",1,2,0,0,2,1,3,6,2,6,2,1,2,0,0,2,1,3,17391.5063047389
"1953",11,0,6,0,2,3,11,2,2,4,1,1,27,0,0,27,1,28,50507.587344472
"1954",2,1,0,0,0,3,3,4,2,3,2,2,1,0,0,0,3,3,13088.0515407169
"1955",0,1,0,0,0,1,1,6,1,7,2,0,0,0,0,0,0,0,57399.8631379761
"1956",15,4,19,0,0,0,19,6,2,3,2,0,2,0,0,0,2,2,3773.24123509359
"1957",0,1,0,0,0,1,1,6,2,2,2,0,0,0,0,0,0,0,17757.2719864726
"1958",1,0,0,0,0,1,1,6,2,7,2,1,0,0,0,0,1,1,154953.903412192
"1959",0,1,0,0,1,0,1,6,1,1,2,0,0,0,0,0,0,0,2809.91210952554
"1960",1,5,0,0,5,1,6,5,2,3,2,1,6,0,0,6,1,7,6448.55110217515
"1961",8,8,0,0,0,16,16,4,1,7,2,4,0,0,0,0,4,4,96452.0524920294
"1962",75,33,33,0,0,75,108,4,2,4,2,2,2,2,0,2,0,4,6143.91201197414
"1963",0,3,0,0,1,2,3,1,2,2,4,0,3,0,0,0,3,3,47832.1022402565
"1964",17,4,16,0,2,3,21,2,1,5,1,13,2,10,0,1,4,15,56768.8398228391
"1965",24,520,531,0,13,0,544,2,2,2,1,70,85,55,0,90,10,155,269583.670745649
"1966",0,7,7,0,0,0,7,2,1,4,2,0,2,2,0,0,0,2,36323.9624245055
"1967",34,14,0,0,48,0,48,6,2,3,2,0,1,0,0,0,1,1,10617.5543388347
"1968",7,40,47,0,0,0,47,1,2,1,2,8,70,68,0,0,10,78,8864.30143659131
"1969",5,1,0,0,1,5,6,5,2,8,2,1,0,0,0,0,1,1,37551.8565379505
"1970",0,0,0,0,0,0,0,6,1,7,2,0,0,0,0,0,0,0,20753.3868729319
"1971",1,0,0,0,0,1,1,2,2,3,2,3,0,0,0,0,3,3,5782.42930650666
"1972",5,0,0,0,4,1,5,6,2,2,2,1,0,0,0,0,1,1,63187.0298507508
"1973",2,9,9,0,0,2,11,4,2,7,2,2,17,17,0,0,2,19,34027.8286031252
"1974",0,2,0,0,2,0,2,5,1,1,2,1,0,0,0,1,0,1,18259.3092875889
"1975",3,0,0,0,0,3,3,3,2,7,1,3,1,0,0,0,4,4,22897.2734506051
"1976",1,2,2,0,0,1,3,5,1,3,2,1,2,0,0,3,0,3,11300.31311883
"1977",1,2,0,0,3,0,3,5,2,6,4,0,2,0,0,2,0,2,60202.6777265295
"1978",2,0,0,1,0,1,2,6,2,3,2,0,0,0,0,0,0,0,6071.42543720637
"1979",2,2,0,0,2,2,4,4,1,7,3,16,7,0,0,0,23,23,90318.9910806503
"1980",1,8,5,0,0,4,9,1,1,5,1,3,0,0,0,0,3,3,539957.475859467
"1981",0,1,0,0,1,0,1,5,2,6,2,7,7,0,0,2,12,14,150638.823098358
"1982",1,0,0,0,0,1,1,4,2,3,2,2,2,0,0,3,1,4,11502.910438243
"1983",1,0,0,0,0,1,1,6,2,6,2,2,0,0,0,1,1,2,10808.3924291139
"1984",1,9,0,0,8,2,10,5,2,8,1,1,1,0,0,0,2,2,101863.136745873
"1985",0,0,0,0,0,0,0,4,1,6,4,0,2,0,0,2,0,2,63264.836887469
"1986",6,0,0,0,5,1,6,6,2,7,2,3,2,0,0,5,0,5,15394.0223573986
"1987",5,0,1,0,1,3,5,3,2,6,4,3,3,3,0,0,3,6,62601.6531205516
"1988",3,2,0,0,5,0,5,6,1,7,2,185,6,49,0,69,73,191,14131.9230316549
"1989",0,10,0,0,0,10,10,5,1,8,4,0,10,0,0,0,10,10,40416.4464107662
"1990",1,0,0,0,0,1,1,4,2,6,2,3,4,0,0,4,3,7,22158.5334904135
"1991",1,0,0,0,0,1,1,5,1,5,2,1,0,0,0,0,1,1,10461.570498928
"1992",3,1,0,0,1,3,4,5,2,3,2,3,6,0,1,4,4,9,5365.55028540108
"1993",0,0,0,0,0,0,0,6,2,5,2,0,1,0,0,1,0,1,16979.7363811661
"1994",0,2,0,0,2,0,2,6,2,1,5,1,2,0,0,3,0,3,15095.2400125932
"1995",1,2,0,0,0,3,3,6,1,4,2,0,1,0,0,0,1,1,13818.8160638884
"1996",2,0,0,0,0,2,2,5,1,8,2,1,4,0,0,4,1,5,98319.4070744561
"1997",1,2,0,0,1,2,3,6,2,2,2,3,5,0,0,8,0,8,6304.53747348999
"1998",0,0,0,0,0,0,0,3,1,7,4,0,25,25,0,0,0,25,59284.0197636463
"1999",2,0,0,0,0,2,2,6,2,1,2,0,0,0,0,0,0,0,46491.1741095786
"2000",48,60,0,0,105,3,108,4,1,8,5,3,3,0,0,3,3,6,418811.56220372
"2001",15,30,0,0,0,45,45,4,2,8,4,0,0,0,0,0,0,0,61676.0950470749
"2002",2,10,0,0,10,2,12,3,1,8,2,38,0,0,0,38,0,38,45745.935270001
"2003",3,2,0,0,4,1,5,5,1,4,2,0,11,0,0,11,0,11,19535.5979311887
"2004",1,1,0,0,1,1,2,6,1,8,2,0,0,0,0,0,0,0,39652.8792679637
"2005",1,0,0,0,0,1,1,6,2,6,2,1,0,0,0,0,1,1,10808.3924291139
"2006",0,0,0,0,0,0,0,4,2,4,2,0,0,0,0,0,0,0,134825.466489285
"2007",1,6,0,0,3,4,7,6,2,3,2,1,3,0,0,1,3,4,12760.6374168906
"2008",1,0,1,0,0,0,1,4,2,2,2,0,3,0,0,1,2,3,19079.9883535507
"2009",0,4,0,0,4,0,4,5,1,3,2,0,1,0,0,0,1,1,19974.1725779914
"2010",2,3,0,0,5,0,5,6,1,3,2,0,1,0,0,1,0,1,68189.7185436643
"2011",3,0,0,0,0,3,3,3,2,6,2,14,12,10,4,6,6,26,14452.4225769093
"2012",0,1,0,0,0,1,1,6,1,5,2,0,5,0,0,5,0,5,22272.8193960805
"2013",1,9,0,0,10,0,10,6,1,3,2,0,0,0,0,0,0,0,3478.59070577614
"2014",2,2,0,0,0,4,4,2,2,5,2,0,1,0,0,1,0,1,30099.2245726041
"2015",1,2,0,0,2,1,3,5,2,4,2,1,1,0,0,2,0,2,13414.8157377904
"2016",1,0,0,0,0,1,1,6,1,3,2,0,0,0,0,0,0,0,12255.1511243045
"2017",0,3,0,0,3,0,3,6,1,3,2,0,4,0,0,0,4,4,15677.0642089194
"2018",2,1,0,0,2,1,3,6,1,3,2,0,2,0,0,0,2,2,19207.7105584147
"2019",0,2,0,0,2,0,2,6,2,5,2,0,0,0,0,0,0,0,9372.82350468581
"2020",1,4,0,0,4,1,5,6,2,5,2,1,2,0,0,1,2,3,7000.71215860504
"2021",0,5,0,0,5,0,5,6,1,8,4,2,3,0,0,0,5,5,61945.3913437165
"2022",1,1,0,0,0,2,2,6,2,8,2,1,9,9,0,0,1,10,90961.355855723
"2023",0,6,0,0,5,1,6,6,1,4,2,2,6,0,0,6,2,8,8718.34862670832
"2024",2,1,0,0,1,2,3,6,2,5,2,1,3,0,0,0,4,4,34597.6593902692
"2025",1,2,0,0,2,1,3,1,2,2,4,0,0,0,0,0,0,0,44786.8169944063
"2026",0,9,0,0,8,1,9,6,2,3,2,3,4,0,0,6,1,7,17049.8706044921
"2027",2,2,0,0,2,2,4,6,2,6,5,0,0,0,0,0,0,0,35741.8097613457
"2028",2,4,0,0,4,2,6,1,2,3,2,8,2,9,0,0,1,10,17068.7825026126
"2029",3,0,0,0,0,3,3,4,2,6,2,2,0,0,0,0,2,2,11674.8620020432
"2030",1,7,0,0,7,1,8,3,2,8,2,2,0,2,0,0,0,2,72290.8591085568
"2031",0,1,0,0,0,1,1,6,1,4,2,0,0,0,0,0,0,0,14315.2030956635
"2032",7,11,0,0,14,4,18,2,2,3,2,1,4,0,0,1,4,5,12643.8537258956
"2033",3,0,0,0,0,3,3,5,2,8,2,1,0,0,0,0,1,1,90686.875261614
"2034",12,28,14,0,24,2,40,3,1,5,2,9,0,7,0,1,1,9,47318.5976322935
"2035",0,3,0,0,0,3,3,6,2,3,2,0,0,0,0,0,0,0,19412.6463275567
"2036",17,20,27,0,10,0,37,2,1,5,1,0,7,6,0,0,1,7,28001.6838274517
"2037",0,3,0,0,0,3,3,4,1,2,3,3,20,0,0,23,0,23,38168.5758570134
"2038",0,1,0,0,0,1,1,4,2,5,1,0,13,11,0,0,2,13,33186.0244804275
"2039",2,1,0,0,3,0,3,3,2,4,2,0,0,0,0,0,0,0,6679.55294168838
"2040",11,0,4,0,0,7,11,1,2,4,1,7,0,0,0,0,7,7,46073.3379634471
"2041",0,1,0,0,0,1,1,3,2,6,4,0,2,0,0,2,0,2,79462.0678857534
"2042",1,2,0,0,0,3,3,6,1,5,2,5,0,0,0,0,5,5,17331.4651598368
"2043",1,0,0,0,0,1,1,5,1,6,4,1,3,3,0,0,1,4,18785.4398859119
"2044",6,4,0,0,7,3,10,3,1,7,2,14,12,18,0,5,3,26,66219.9182529026
"2045",5,10,0,0,12,3,15,4,1,8,2,0,8,1,0,4,3,8,19256.5937315529
"2046",1,1,0,0,1,1,2,6,1,6,2,0,0,0,0,0,0,0,7726.52543762922
"2047",1,4,0,0,5,0,5,6,2,6,2,1,0,0,0,0,1,1,30413.8237609184
"2048",0,0,0,0,0,0,0,3,2,4,2,0,0,0,0,0,0,0,10375.2080114007
"2049",3,60,62,0,0,1,63,1,1,2,2,4,0,0,0,0,4,4,46541.3199274261
"2050",1,1,0,0,2,0,2,5,1,3,3,0,0,0,0,0,0,0,86806.3304819558
"2051",1,2,0,0,1,2,3,1,2,6,2,0,0,0,0,0,0,0,45894.9720718302
"2052",3,5,0,0,3,5,8,3,2,7,2,3,4,0,0,3,4,7,47402.5536147821
"2053",4,1,0,0,1,4,5,4,1,7,2,3,14,11,0,2,4,17,41905.0944305381
"2054",1,0,0,0,0,1,1,1,1,4,2,81,51,80,0,50,2,132,77473.5021975205
"2055",1,4,0,0,2,3,5,6,1,8,2,1,3,0,0,2,2,4,16623.443645073
"2056",1,5,4,0,0,2,6,2,1,5,5,1,0,0,0,0,1,1,118496.412443624
"2057",0,12,12,0,0,0,12,3,1,4,4,1,15,13,0,0,3,16,69895.2564379338
"2058",10,12,18,0,2,2,22,3,1,3,4,54,10,35,0,26,3,64,38041.3576145456
"2059",5,1,5,0,0,1,6,5,2,8,2,4,0,3,0,0,1,4,14566.4902366812
"2060",3,3,0,0,2,4,6,2,2,7,1,2,0,0,0,0,2,2,145514.774932252
"2061",0,0,0,0,0,0,0,6,1,6,2,1,0,0,0,0,1,1,18430.5362282723
"2062",3,3,0,0,0,6,6,2,2,4,4,10,0,0,0,6,4,10,51224.6253683733
"2063",3,12,0,0,11,4,15,2,2,4,2,2,3,0,0,3,2,5,50874.1250143925
"2064",0,0,0,0,0,0,0,6,2,2,2,0,0,0,0,0,0,0,58090.8669397983
"2065",0,8,0,0,3,5,8,2,2,5,1,0,6,0,0,3,3,6,72066.6661721365
"2066",3,1,0,0,0,4,4,3,2,3,4,3,2,0,0,2,3,5,11514.6306191222
"2067",6,4,7,0,0,3,10,5,1,6,2,6,15,15,0,1,5,21,24957.2940491618
"2068",2,2,0,0,0,4,4,5,2,1,1,4,0,0,0,0,4,4,71784.9380252691
"2069",1,1,0,0,1,1,2,3,2,7,2,6,3,0,0,8,1,9,22523.5547282052
"2070",2,2,0,0,4,0,4,5,2,6,2,0,1,0,0,0,1,1,12788.3032351136
"2071",3,0,0,0,2,1,3,2,2,2,2,0,1,0,0,0,1,1,42411.6346890053
"2072",1,9,0,0,8,2,10,2,1,6,1,3,1,0,0,3,1,4,511007.570686588
"2073",2,2,0,0,2,2,4,3,2,5,2,2,1,0,0,1,2,3,12769.8177173587
"2074",1,7,0,0,7,1,8,3,1,4,2,1,0,0,0,0,1,1,25498.8862331961
"2075",11,12,13,0,0,10,23,4,2,3,2,13,3,0,0,0,16,16,26668.0199929533
"2076",0,0,0,0,0,0,0,4,2,2,2,0,0,0,0,0,0,0,11530.3801312172
"2077",2,1,0,0,1,2,3,5,2,8,2,2,0,0,0,0,2,2,37551.8565379505
"2078",1,0,0,0,0,1,1,6,2,4,2,1,1,0,0,0,2,2,7060.5136267019
"2079",0,0,0,0,0,0,0,6,2,5,2,0,0,0,0,0,0,0,9082.86400415186
"2080",7,0,0,0,0,7,7,3,1,3,1,0,17,15,0,0,2,17,55033.4932948993
"2081",1,0,0,0,0,1,1,5,1,7,2,0,1,0,0,0,1,1,226920.265241348
"2082",3,36,0,0,36,3,39,6,2,4,4,3,30,0,0,30,3,33,33525.5279386185
"2083",1,7,7,0,0,1,8,3,1,6,2,0,2,0,0,2,0,2,12636.3912169465
"2084",0,0,0,0,0,0,0,5,2,2,2,0,0,0,0,0,0,0,5588.16767500042
"2085",0,4,0,0,2,2,4,5,1,6,2,1,7,0,0,6,2,8,24091.8870387677
"2086",1,1,0,0,1,1,2,5,1,7,2,1,0,0,0,0,1,1,83583.3009670033
"2087",1,9,0,0,8,2,10,6,2,4,2,5,5,0,0,10,0,10,9452.88801713745
"2088",0,30,29,0,0,1,30,6,1,5,4,1,6,6,0,0,1,7,33914.130139805
"2089",0,1,0,0,0,1,1,6,2,2,2,0,0,0,0,0,0,0,11025.2147371837
"2090",1,0,0,0,1,0,1,5,1,8,1,1,1,0,0,1,1,2,61400.3368060745
"2091",3,8,0,0,10,1,11,5,1,6,4,0,9,0,0,7,2,9,60233.7063702651
"2092",2,2,0,0,0,4,4,6,1,5,2,1,2,0,0,0,3,3,107493.243545165
"2093",12,15,18,0,0,9,27,1,1,3,1,7,21,20,0,0,8,28,76984.6106934688
"2094",3,8,7,0,1,3,11,3,1,7,4,3,4,4,0,0,3,7,96845.0761640739
"2095",5,2,0,0,0,7,7,6,1,3,4,3,3,0,0,0,6,6,97686.0034742739
"2096",15,0,0,0,14,1,15,2,1,4,5,0,0,0,0,0,0,0,164929.658604222
"2097",2,8,8,0,0,2,10,4,2,5,2,12,26,36,0,0,2,38,23440.991020231
"2098",0,0,0,0,0,0,0,6,2,5,2,0,1,0,0,0,1,1,18761.0315306294
"2099",2,5,5,0,0,2,7,4,2,5,4,2,0,0,0,0,2,2,46008.4174843428
"2100",1,1,0,0,0,2,2,6,1,7,2,1,6,4,0,1,2,7,34920.5980990647
"2101",0,2,0,0,2,0,2,5,2,4,2,0,0,0,0,0,0,0,8679.75345067739
"2102",1,0,0,0,0,1,1,2,1,8,2,1,0,0,0,0,1,1,60600.3846253414
"2103",0,0,0,0,0,0,0,3,1,8,2,13,0,0,0,8,5,13,35818.044844768
"2104",1,3,0,0,0,4,4,1,2,5,2,2,7,0,0,8,1,9,24097.5805849152
"2105",4,2,0,0,0,6,6,3,2,8,1,4,5,0,0,0,9,9,57683.4320254469
"2106",10,11,8,0,13,0,21,4,1,5,1,5,15,8,0,12,0,20,34275.2426828326
"2107",2,1,0,0,0,3,3,4,2,5,4,2,0,0,0,0,2,2,21861.1241408639
"2108",1,1,0,0,1,1,2,4,2,8,2,0,31,31,0,0,0,31,28524.7841582728
"2109",1,1,0,0,1,1,2,5,2,5,2,1,0,0,0,1,0,1,9955.01500705993
"2110",1,1,0,0,1,1,2,6,1,8,2,1,4,0,0,4,1,5,16047.0171847765
"2111",8,1,0,0,8,1,9,6,1,8,2,4,4,0,0,1,7,8,16623.443645073
"2112",4,1,0,0,1,4,5,4,1,4,1,1,13,0,0,13,1,14,439802.830434203
"2113",1,0,0,0,0,1,1,1,2,2,4,1,10,9,0,0,2,11,38733.9236216099
"2114",0,3,3,0,0,0,3,4,2,3,1,1,0,0,0,0,1,1,67018.6168656973
"2115",1,0,0,0,0,1,1,2,1,6,3,0,1,0,0,1,0,1,36578.3240512912
"2116",2,0,0,0,0,2,2,4,1,6,2,2,0,0,0,0,2,2,22911.3035330402
"2117",2,4,0,0,2,4,6,3,2,3,1,3,5,1,0,3,4,8,30701.1021508896
"2118",0,0,0,0,0,0,0,6,1,8,2,1,0,0,0,0,1,1,16047.0171847765
"2119",5,8,0,0,8,5,13,2,2,4,1,5,0,0,0,0,5,5,36681.1868801976
"2120",10,18,22,0,0,6,28,3,1,8,2,8,0,5,0,0,3,8,19177.7997207483
"2121",0,4,0,0,0,4,4,6,2,6,4,0,3,0,0,3,0,3,317677.615292818
"2122",1,5,4,0,0,2,6,3,1,8,2,3,20,23,0,0,0,23,47389.1794465981
"2123",0,7,0,0,7,0,7,5,2,3,2,0,0,0,0,0,0,0,9749.16382624858
"2124",3,0,0,0,0,3,3,4,2,8,2,3,0,0,0,0,3,3,45898.4966343036
"2125",1,2,0,0,2,1,3,4,1,8,2,1,0,0,0,0,1,1,19948.3117022034
"2126",10,10,0,0,20,0,20,3,2,1,1,0,0,0,0,0,0,0,26958.6272963553
"2127",3,2,0,0,2,3,5,3,2,3,2,5,1,0,0,1,5,6,11726.4340542358
"2128",17,17,14,0,16,4,34,4,1,6,2,11,0,11,0,0,0,11,9550.41357183207
"2129",5,0,0,0,0,5,5,1,2,1,4,5,0,0,0,0,5,5,31810.1775449555
"2130",1,4,0,0,5,0,5,4,1,3,1,5,5,0,0,10,0,10,22285.0219321045
"2131",4,2,0,0,0,6,6,2,2,6,2,4,0,0,0,0,4,4,17894.0870397037
"2132",9,0,0,0,0,9,9,4,2,4,2,3,1,0,0,3,1,4,25496.1573346027
"2133",3,0,0,0,0,3,3,6,2,5,3,3,2,0,0,2,3,5,17501.5282113213
"2134",0,12,12,0,0,0,12,5,1,4,3,9,5,14,0,0,0,14,39108.3156319053
"2135",3,3,0,3,0,3,6,4,2,8,2,0,4,0,0,4,0,4,14950.2097316897
"2136",9,0,0,0,3,6,9,4,1,2,5,0,0,0,0,0,0,0,50465.8770575482
"2137",4,0,0,0,0,4,4,3,2,1,1,0,0,0,0,0,0,0,4777.97689676906
"2138",6,6,12,0,0,0,12,2,2,3,1,100,0,22,0,70,8,100,11666.78212047
"2139",1,11,10,0,0,2,12,2,2,6,2,6,7,12,0,0,1,13,9693.61171701475
"2140",2,3,0,0,3,2,5,4,2,4,1,0,1,0,0,0,1,1,14640.1011105552
"2141",1,0,0,0,0,1,1,2,1,5,2,2,1,0,0,0,3,3,36261.9495464014
"2142",10,0,0,0,0,10,10,4,2,2,1,6,0,0,0,0,6,6,29061.9937250393
"2143",0,0,0,0,0,0,0,4,2,4,5,1,2,0,0,3,0,3,25817.8876120351
"2144",0,0,0,0,0,0,0,2,2,1,1,3,8,8,0,3,0,11,1978.52847032012
"2145",1,1,0,0,0,2,2,5,1,5,2,0,0,0,0,0,0,0,3412.78731569996
"2146",1,0,0,0,1,0,1,3,1,6,2,0,2,0,0,2,0,2,103240.532164197
"2147",0,1,0,0,1,0,1,3,2,3,1,0,13,12,0,0,1,13,6286.55550549089
"2148",2,0,0,0,1,1,2,4,2,2,5,0,3,0,0,0,3,3,17819.838107629
"2149",1,88,89,0,0,0,89,2,2,3,1,4,47,48,0,0,3,51,6691.29004843857
"2150",1,0,0,0,0,1,1,2,1,6,2,1,3,0,0,3,1,4,3712.84687404922
"2151",16,0,15,0,0,1,16,2,1,2,1,0,0,0,0,0,0,0,7718.2596796475
"2152",1,0,0,0,0,1,1,2,2,4,1,1,0,0,0,0,1,1,16401.9149985083
"2153",8,0,0,0,0,8,8,2,2,1,1,0,2,0,0,2,0,2,11547.9563725477
"2154",0,0,0,0,0,0,0,2,2,4,1,0,0,0,0,0,0,0,137562.629961586
"2155",12,3,4,0,3,8,15,1,2,2,1,5,4,0,0,4,5,9,17971.2498991571
"2156",3,0,0,0,0,3,3,3,2,6,5,3,5,3,0,0,5,8,48986.389349651
"2157",2,0,0,0,0,2,2,2,1,2,1,23,2,0,0,0,25,25,61249.5883982266
"2158",1,0,0,0,0,1,1,2,2,5,5,1,0,0,0,0,1,1,30860.6741651475
"2159",0,0,0,0,0,0,0,6,2,4,1,2,1,0,0,3,0,3,8028.71933253825
"2160",1,1,0,0,0,2,2,5,1,2,1,0,7,0,0,7,0,7,7052.91729261556
"2161",11,0,0,0,4,7,11,2,2,4,1,14,5,0,0,8,11,19,28761.72087276
"2162",1,2,0,0,1,2,3,5,2,5,1,2,0,0,0,0,2,2,9432.07846566285
"2163",27,2,0,0,25,4,29,1,2,3,1,6,0,0,0,1,5,6,73920.3548225287
"2164",0,0,0,0,0,0,0,6,1,3,1,0,4,0,0,4,0,4,5492.71395244743
"2165",1,7,7,0,0,1,8,5,1,8,1,1,7,0,0,5,3,8,19879.9868123395
"2166",3,0,0,0,0,3,3,3,2,1,1,8,0,0,0,0,8,8,8270.6886837067
"2167",0,1,0,0,1,0,1,2,1,3,1,1,11,11,0,0,1,12,24234.468062939
"2168",0,0,0,0,0,0,0,5,1,6,1,1,6,0,0,6,1,7,3805.29620855712
"2169",0,0,0,0,0,0,0,3,2,3,1,0,3,0,0,3,0,3,9868.38217319391
"2170",0,0,0,0,0,0,0,1,2,2,3,0,0,0,0,0,0,0,30464.121115677
"2171",2,0,0,0,0,2,2,4,1,5,2,2,0,0,0,0,2,2,13491.1661099739
"2172",8,11,0,5,10,4,19,1,2,8,1,4,1,0,0,3,2,5,100782.467224645
"2173",5,0,1,0,0,4,5,1,2,3,2,4,0,0,0,0,4,4,7280.98169444263
"2174",5,10,8,0,0,7,15,4,1,4,1,52,0,50,0,0,2,52,5411.31160775911
"2175",3,2,0,0,0,5,5,4,2,4,1,1,0,0,0,0,1,1,5202.76434981251
"2176",41,0,40,0,0,1,41,2,2,6,2,0,7,0,0,3,4,7,8737.67217620726
"2177",3,0,0,0,0,3,3,5,2,5,1,0,0,0,0,0,0,0,57981.8643927009
"2178",22,4,4,0,0,22,26,1,2,3,1,1,1,1,0,1,0,2,20664.435945263
"2179",0,4,2,0,2,0,4,3,1,5,1,0,0,0,0,0,0,0,4425.19993496676
"2180",1,1,0,0,0,2,2,5,1,7,2,1,1,0,0,0,2,2,17239.9144902398
"2181",1,0,0,0,0,1,1,2,1,5,2,1,0,0,0,0,1,1,10491.6331509165
"2182",11,0,0,0,10,1,11,3,2,6,1,2,0,0,0,0,2,2,11339.0523341081
"2183",0,21,21,0,0,0,21,2,2,3,4,0,15,15,0,0,0,15,5036.49410610275
"2184",0,4,1,0,3,0,4,4,2,7,5,0,2,0,0,2,0,2,17581.4704605919
"2185",0,0,0,0,0,0,0,1,1,2,1,2,0,0,0,0,2,2,26036.6323806281
"2186",4,1,0,0,0,5,5,4,1,3,1,8,1,0,0,5,4,9,35672.623560534
"2187",3,0,0,0,0,3,3,2,2,3,1,3,0,0,0,1,2,3,18828.2076346246
"2188",1,2,0,0,2,1,3,5,2,6,2,1,0,0,0,0,1,1,15947.6396967959
"2189",2,0,0,0,0,2,2,1,2,3,1,1,1,0,0,0,2,2,17306.7579080841
"2190",2,1,0,0,1,2,3,6,2,6,1,1,0,0,0,1,0,1,12290.5434133157
"2191",4,70,70,0,0,4,74,1,2,1,1,5,0,1,0,0,4,5,29455.3880415462
"2192",0,3,0,0,3,0,3,3,1,3,4,2,0,0,0,0,2,2,21505.8705384137
"2193",10,2,0,0,8,4,12,3,1,4,1,1,2,0,0,2,1,3,81135.5190520278
"2194",3,0,0,0,0,3,3,2,1,3,1,1,3,0,0,0,4,4,18723.6141396037
"2195",0,3,0,0,3,0,3,3,1,8,2,0,3,3,0,0,0,3,15390.5940010378
"2196",18,0,13,0,0,5,18,4,1,7,1,2,2,2,0,0,2,4,106603.215615937
"2197",4,3,0,0,3,4,7,4,1,6,1,6,10,0,0,11,5,16,13943.1475027591
"2198",35,10,10,0,0,35,45,2,2,3,1,5,0,0,0,0,5,5,15724.2258718501
"2199",0,3,0,0,0,3,3,5,2,3,1,3,0,0,0,0,3,3,28508.2360717422
"2200",4,7,0,0,6,5,11,5,1,2,2,1,4,0,0,0,5,5,9307.55643518316
"2201",5,0,3,0,0,2,5,3,1,6,1,0,32,20,0,10,2,32,109532.096479468
"2202",0,0,0,0,0,0,0,6,1,3,2,4,1,3,0,1,1,5,5885.98429974809
"2203",0,0,0,0,0,0,0,6,2,2,2,0,0,0,0,0,0,0,20505.4581964291
"2204",1,3,0,0,2,2,4,6,2,5,2,1,2,0,0,2,1,3,10422.7811468134
"2205",1,3,0,0,0,4,4,6,1,3,1,4,0,0,0,1,3,4,42988.9263162529
"2206",8,6,5,0,0,9,14,2,1,6,1,6,1,0,0,5,2,7,41352.0173141464
"2207",0,0,0,0,0,0,0,6,1,4,1,0,3,0,0,3,0,3,20051.7918105197
"2208",0,0,0,0,0,0,0,4,1,5,1,0,0,0,0,0,0,0,23310.4290059274
"2209",3,0,0,0,0,3,3,3,2,8,1,7,1,0,1,0,7,8,33440.359991743
"2210",2,0,0,0,1,1,2,2,2,2,1,1,20,20,0,0,1,21,25203.4014371128
"2211",0,0,0,0,0,0,0,1,2,7,1,9,4,0,0,13,0,13,33594.7610855566
"2212",1,4,0,0,1,4,5,6,1,3,1,1,0,0,0,0,1,1,8647.6446749142
"2213",0,0,0,0,0,0,0,5,2,2,1,0,0,0,0,0,0,0,7857.86204819482
"2214",0,12,7,0,5,0,12,5,2,6,1,0,8,6,0,2,0,8,21676.4604743159
"2215",4,0,0,0,0,4,4,2,2,4,1,20,2,0,0,2,20,22,12267.3128593254
"2216",0,0,0,0,0,0,0,1,1,3,1,6,0,0,0,2,4,6,123910.474014037
"2217",0,2,0,0,0,2,2,1,2,2,1,1,1,0,0,0,2,2,24379.4832776016
"2218",8,1,0,0,5,4,9,4,2,5,2,4,0,0,0,0,4,4,22464.4972798607
"2219",3,2,0,0,0,5,5,4,2,3,1,3,0,0,0,0,3,3,5376.95500704999
"2220",2,0,0,0,0,2,2,5,2,6,1,1,3,0,0,3,1,4,21676.4604743159
"2221",15,3,14,0,0,4,18,2,2,7,1,5,9,12,0,0,2,14,47114.2660958095
"2222",0,0,0,0,0,0,0,3,2,6,1,0,0,0,0,0,0,0,30987.5094718457
"2223",2,9,7,0,0,4,11,5,1,2,2,4,7,7,0,0,4,11,34107.3695590552
"2224",13,0,0,0,10,3,13,4,2,8,1,3,4,0,0,5,2,7,72140.8993788377
"2225",3,0,0,0,0,3,3,6,1,5,1,2,5,1,0,0,6,7,19088.6657343998
"2226",3,2,0,2,0,3,5,2,2,3,1,0,2,0,0,1,1,2,49288.9887814359
"2227",1,9,6,0,3,1,10,4,2,2,1,14,5,11,0,7,1,19,15589.3997107857
"2228",0,0,0,0,0,0,0,6,1,6,1,0,0,0,0,0,0,0,6194.94304142185
"2229",2,2,0,0,3,1,4,6,2,4,2,1,0,0,0,0,1,1,5906.82797561583
"2230",4,8,0,0,8,4,12,3,2,7,1,4,0,0,1,0,3,4,19493.5681822587
"2231",6,0,0,4,0,2,6,1,1,3,1,2,0,0,0,2,0,2,34903.1579957845
"2232",7,0,0,0,0,7,7,2,2,1,1,1,1,0,0,0,2,2,8636.94231562391
"2233",2,45,46,0,0,1,47,2,1,2,1,4,34,37,0,0,1,38,30605.2283399008
"2234",4,1,1,0,0,4,5,2,1,3,1,1,2,0,0,0,3,3,30776.4742749441
"2235",2,0,0,0,0,2,2,2,1,4,1,1,3,1,0,0,3,4,16438.8630804058
"2236",26,36,53,0,1,8,62,3,2,4,1,12,122,122,0,0,12,134,17533.9458226627
"2237",11,2,12,0,0,1,13,4,2,5,1,8,0,8,0,0,0,8,13824.6636397842
"2238",2,0,0,0,0,2,2,4,2,3,1,13,3,0,0,4,12,16,16805.7731994404
"2239",9,19,0,1,19,8,28,1,2,5,1,14,2,0,0,7,9,16,72542.7346738024
"2240",1,0,0,0,0,1,1,6,2,4,2,5,0,0,0,0,5,5,51697.0049449041
"2241",3,0,0,0,0,3,3,3,2,6,1,6,0,0,0,0,6,6,13449.6440244829
"2242",0,0,0,0,0,0,0,6,1,3,1,0,0,0,0,0,0,0,8907.39324905581
"2243",6,0,0,0,0,6,6,2,2,5,1,3,0,0,0,0,3,3,77431.7767354444
"2244",1,20,0,0,21,0,21,3,1,5,1,0,1,0,0,0,1,1,4058.54746196252
"2245",9,2,0,0,5,6,11,2,2,2,1,2,6,0,0,0,8,8,25647.7162351434
"2246",4,0,0,0,0,4,4,2,2,2,1,4,0,0,0,0,4,4,42712.716310641
"2247",2,0,0,0,0,2,2,6,2,6,2,0,4,0,0,0,4,4,23774.69026825
"2248",1,0,0,0,0,1,1,3,2,5,1,1,3,0,0,2,2,4,54496.200094279
"2249",0,0,0,0,0,0,0,4,2,2,1,0,2,0,0,0,2,2,62610.9070953377
"2250",0,2,0,0,2,0,2,5,1,8,2,0,2,1,0,1,0,2,11142.5000572754
"2251",0,16,10,0,3,3,16,2,2,3,1,0,0,0,0,0,0,0,27698.5124088475
"2252",2,0,0,0,1,1,2,2,1,8,2,2,0,0,0,1,1,2,12525.6355043155
"2253",1,0,0,0,0,1,1,6,2,1,2,0,1,0,0,0,1,1,9395.40391967784
"2254",0,2,0,0,2,0,2,4,1,3,1,0,0,0,0,0,0,0,9788.24018513116
"2255",0,5,0,0,5,0,5,4,1,8,1,4,0,0,0,4,0,4,19411.474042227
"2256",0,0,0,0,0,0,0,2,2,4,1,0,1,0,0,0,1,1,21990.0469283794
"2257",0,0,0,0,0,0,0,6,2,2,1,0,1,0,0,1,0,1,7952.48908169205
"2258",1,1,0,0,0,2,2,3,2,4,1,1,0,0,0,0,1,1,73486.1356810708
"2259",8,0,0,0,6,2,8,2,1,8,2,4,2,0,0,2,4,6,30951.3915694146
"2260",1,2,2,0,0,1,3,3,2,8,1,0,0,0,0,0,0,0,43806.032552423
"2261",3,8,0,0,8,3,11,3,2,6,1,3,2,0,0,2,3,5,11190.8458490412
"2262",6,1,0,0,1,6,7,2,2,5,1,1,1,0,0,2,0,2,12163.4105998897
"2263",3,1,0,0,2,2,4,3,2,4,2,2,3,0,0,3,2,5,4087.96790079034
"2264",0,5,0,0,5,0,5,4,2,8,2,3,4,5,0,0,2,7,23036.3525657604
"2265",0,4,3,0,0,1,4,6,1,1,1,2,2,2,0,1,1,4,20900.9952949775
"2266",1,0,0,0,0,1,1,6,2,1,1,0,0,0,0,0,0,0,11665.8245521781
"2267",2,3,0,0,3,2,5,5,2,7,2,2,0,0,0,0,2,2,14994.6316029964
"2268",1,4,2,0,0,3,5,3,2,4,1,0,2,2,0,0,0,2,30886.367310109
"2269",3,1,0,0,1,3,4,3,2,8,2,2,0,0,0,0,2,2,15024.9610180689
"2270",3,6,0,0,6,3,9,3,1,7,2,0,0,0,0,0,0,0,11567.3377932187
"2271",3,3,0,0,1,5,6,5,2,6,5,0,0,0,0,0,0,0,34665.6602148647
"2272",2,25,25,0,0,2,27,4,2,7,2,9,9,14,0,0,4,18,55951.1130572677
"2273",5,3,0,0,6,2,8,5,1,7,1,4,2,0,0,4,2,6,9498.91993266086
"2274",20,0,16,0,0,4,20,2,2,2,1,8,20,22,0,0,6,28,29269.0450437907
"2275",4,0,0,0,3,1,4,6,1,4,2,5,0,0,0,4,1,5,11465.3987500473
"2276",0,1,0,0,0,1,1,6,2,3,3,0,1,0,0,1,0,1,19350.8086844175
"2277",11,14,17,0,0,8,25,1,1,3,1,3,6,0,0,6,3,9,123910.474014037
"2278",1,0,0,0,0,1,1,6,2,4,2,1,0,0,0,0,1,1,5906.82797561583
"2279",3,1,0,0,1,3,4,2,2,2,2,1,16,14,0,0,3,17,10603.1126959713
"2280",40,0,0,0,0,40,40,3,2,2,3,3,3,0,0,3,3,6,34713.5257837061
"2281",0,2,2,0,0,0,2,5,1,4,1,0,1,0,0,1,0,1,15481.1800224262
"2282",0,0,0,0,0,0,0,5,2,3,1,0,1,0,0,1,0,1,6631.04511216649
"2283",4,20,21,0,0,3,24,4,1,6,1,8,2,0,0,10,0,10,5642.61490507749
"2284",2,6,0,0,6,2,8,3,1,8,3,2,0,0,0,0,2,2,14687.4143721496
"2285",1,0,0,0,1,0,1,5,1,8,2,0,3,1,0,0,2,3,1900.98444860744
"2286",3,3,0,0,0,6,6,4,2,8,2,3,0,0,0,0,3,3,4733.4309824857
"2287",2,0,0,0,0,2,2,4,1,4,4,26,26,50,0,0,2,52,59910.8099828805
"2288",0,2,0,0,0,2,2,4,2,5,2,5,8,8,0,0,5,13,2019.12241014942
"2289",3,22,0,0,22,3,25,3,1,6,2,13,25,32,0,0,6,38,1817.09221553473
"2290",2,7,5,3,0,1,9,3,2,8,2,0,12,10,0,0,2,12,4967.65904359411
"2291",0,2,0,0,0,2,2,5,2,5,2,0,3,1,0,0,2,3,1423.88332031871
"2292",0,0,0,0,0,0,0,3,2,5,2,0,0,0,0,0,0,0,2119.03622087567
"2293",12,4,0,0,9,7,16,6,2,5,2,5,13,0,0,10,8,18,3386.35513751171
"2294",2,2,0,0,4,0,4,3,2,3,3,0,2,0,0,0,2,2,4003.53310342469
"2295",3,3,0,0,2,4,6,4,2,6,2,2,0,0,0,0,2,2,2593.78309640843
"2296",1,1,0,0,0,2,2,5,1,8,2,0,0,0,0,0,0,0,6659.16866447246
"2297",3,0,0,0,3,0,3,2,1,3,2,2,1,0,0,2,1,3,2023.31468520139
"2298",100,0,0,0,0,100,100,3,2,2,2,1,2,2,0,0,1,3,10895.2030333109
"2299",0,0,0,0,0,0,0,2,1,5,2,0,4,4,0,0,0,4,4683.96263586651
"2300",4,8,0,0,4,8,12,4,1,8,2,27,441,440,0,27,1,468,7301.18327514449
"2301",1,0,0,0,0,1,1,4,1,3,2,0,0,0,0,0,0,0,809.936213789201
"2302",7,1,0,0,5,3,8,1,1,6,2,2,0,0,0,0,2,2,12556.6121314167
"2303",6,4,0,0,4,6,10,4,2,6,2,5,0,0,0,0,5,5,4106.98945914483
"2304",1,1,0,0,0,2,2,6,2,7,2,0,1,0,0,0,1,1,2201.83411594744
"2305",4,10,8,0,0,6,14,5,1,8,2,4,8,8,0,0,4,12,4534.53017559625
"2306",1,3,0,0,3,1,4,5,1,3,3,1,2,3,0,0,0,3,8387.53551097853
"2307",4,1,0,0,5,0,5,6,1,6,2,1,6,0,0,6,1,7,2650.28071175983
"2308",3,19,19,0,0,3,22,3,2,8,2,3,0,0,0,0,3,3,4967.65904359411
"2309",1,4,0,0,0,5,5,5,1,5,2,1,2,0,0,0,3,3,1549.5428151413
"2310",24,10,33,0,0,1,34,2,2,1,2,2,0,0,0,0,2,2,1219.20216496268
"2311",3,0,0,0,2,1,3,2,2,4,2,0,3,3,0,0,0,3,2479.50470232566
"2312",1,1,0,0,1,1,2,6,2,5,2,1,1,0,0,1,1,2,1001.32418343125
"2313",0,0,0,0,0,0,0,6,2,4,2,0,1,0,0,0,1,1,1049.27192234459
"2314",0,5,0,0,5,0,5,5,1,5,2,0,0,0,0,0,0,0,809.936213789201
"2315",1,0,0,0,0,1,1,6,2,7,2,1,2,0,0,0,3,3,3542.91465272309
"2316",1,0,0,0,0,1,1,4,2,7,2,4,1,0,0,0,5,5,4599.3792140908
"2317",3,0,0,0,1,2,3,1,2,4,3,1,0,0,0,0,1,1,38821.6662930647
"2318",18,22,37,0,0,3,40,4,2,8,2,5,7,2,5,2,3,12,10034.4644623555
"2319",1,0,0,0,0,1,1,6,2,3,2,1,0,0,0,0,1,1,1254.35048545771
"2320",10,3,0,0,3,10,13,3,2,5,3,5,0,0,0,0,5,5,19472.1638067388
"2321",1,0,0,0,0,1,1,6,1,4,2,2,1,0,0,0,3,3,1929.17644798035
"2322",0,0,0,0,0,0,0,5,1,3,2,0,0,0,0,0,0,0,1568.61984315925
"2323",2,0,0,0,2,0,2,6,1,5,2,3,8,0,0,9,2,11,4354.03361187237
"2324",10,7,0,0,10,7,17,4,1,8,2,10,10,0,0,10,10,20,6842.48387755836
"2325",10,0,0,0,0,10,10,6,1,6,2,0,1,0,0,0,1,1,2650.28071175983
"2326",8,0,0,0,8,0,8,4,2,5,2,6,1,2,0,3,2,7,1676.62243711279
"2327",0,0,0,0,0,0,0,6,2,3,2,0,0,0,0,0,0,0,6528.98002394915
"2328",1,0,0,0,0,1,1,3,2,8,2,0,0,0,0,0,0,0,7993.33241673784
"2329",0,0,0,0,0,0,0,2,2,5,2,0,2,0,0,1,1,2,2546.8158265774
"2330",1,0,0,0,0,1,1,4,1,8,2,1,0,0,0,0,1,1,2769.0664182978
"2331",4,2,3,0,0,3,6,2,2,6,3,20,20,0,0,40,0,40,8279.98303138066
"2332",1,0,0,0,0,1,1,6,2,7,2,1,0,0,0,0,1,1,2646.25976087341
"2333",10,0,0,0,0,10,10,3,2,8,2,2,10,0,0,9,3,12,4967.65904359411
"2334",2,0,0,0,0,2,2,3,2,7,2,2,0,0,0,0,2,2,2895.82409688253
"2335",1,0,0,0,0,1,1,3,1,8,2,1,7,7,0,0,1,8,2662.11005604546
"2336",2,0,0,0,0,2,2,4,2,6,2,2,1,0,0,0,3,3,1937.33818317743
"2337",0,2,0,0,0,2,2,6,1,6,2,0,4,0,0,0,4,4,1269.8217007603
"2338",2,5,0,0,5,2,7,4,1,6,3,5,0,0,0,4,1,5,27841.9002707648
"2339",1,0,0,0,0,1,1,5,2,4,2,1,0,0,0,0,1,1,4023.48790506039
"2340",0,35,35,0,0,0,35,3,2,7,2,1,2,0,0,2,1,3,4659.59608412147
"2341",0,0,0,0,0,0,0,6,2,2,3,0,0,0,0,0,0,0,10636.6314236777
"2342",2,0,0,0,0,2,2,2,2,6,2,2,6,0,0,0,8,8,8046.51630046598
"2343",1,0,0,0,0,1,1,3,1,6,2,1,1,1,0,0,1,2,1237.34055981236
"2344",0,3,0,0,3,0,3,4,2,5,2,0,0,0,0,0,0,0,1685.02895251248
"2345",1,1,0,0,0,2,2,2,1,5,1,1,1,0,0,1,1,2,6196.14920860395
"2346",4,8,1,0,8,3,12,4,2,7,2,0,8,1,0,0,7,8,4439.89337369904
"2347",8,0,0,0,4,4,8,2,1,8,2,13,3,7,0,7,2,16,12353.5087254725
"2348",2,5,0,0,5,2,7,3,1,4,4,2,2,0,0,2,2,4,5350.17296979224
"2349",3,21,20,0,4,0,24,2,2,3,2,1,12,12,0,1,0,13,2797.05246348664
"2350",0,11,0,0,10,1,11,6,2,5,2,3,1,0,0,3,1,4,1936.41605827276
"2351",0,4,4,0,0,0,4,1,1,2,2,0,0,0,0,0,0,0,2899.6212313734
"2352",1,0,0,0,0,1,1,3,2,4,3,1,0,0,0,0,1,1,9966.39668913687
"2353",3,0,0,0,0,3,3,5,1,8,2,8,23,25,0,0,6,31,2694.88107718446
"2354",0,0,0,0,0,0,0,5,2,4,2,0,0,0,0,0,0,0,2518.80703653044
"2355",1,0,0,0,0,1,1,2,2,1,4,0,0,0,0,0,0,0,4010.37167016049
"2356",1,0,0,0,0,1,1,2,1,7,1,4,6,0,0,10,0,10,9305.33468666026
"2357",0,0,0,0,0,0,0,2,2,5,2,3,3,0,0,6,0,6,5809.44540635016
"2358",26,24,0,0,44,6,50,3,1,7,2,0,2,0,0,0,2,2,6001.22679158265
"2359",3,0,3,0,0,0,3,2,1,6,3,0,0,0,0,0,0,0,80444.3385163854
"2360",6,8,3,0,9,2,14,2,1,4,2,6,0,3,0,0,3,6,11285.5353174177
"2361",0,0,0,0,0,0,0,5,2,5,3,0,6,0,0,6,0,6,3092.7043642587
"2362",25,0,24,0,0,1,25,4,2,4,2,45,45,89,0,0,1,90,2720.85527394873
"2363",1,0,0,0,0,1,1,2,1,5,2,1,1,0,0,1,1,2,4683.96263586651
"2364",3,0,0,0,0,3,3,2,1,4,5,2,0,0,0,2,0,2,37631.8154784565
"2365",0,3,0,0,3,0,3,5,2,5,2,0,7,0,0,6,1,7,974.840371768514
"2366",6,4,4,2,0,4,10,3,1,5,2,0,13,0,0,13,0,13,3204.886318742
"2367",5,2,0,0,0,7,7,6,2,1,2,1,2,0,0,0,3,3,809.936213789201
"2368",0,0,0,0,0,0,0,6,2,3,2,0,0,0,0,0,0,0,809.936213789201
"2369",7,0,0,2,0,5,7,1,2,6,4,2,5,0,0,5,2,7,55932.9571849195
"2370",0,7,0,0,6,1,7,6,2,5,2,0,2,0,0,1,1,2,6787.14194048762
"2371",0,0,0,0,0,0,0,6,2,3,3,0,1,0,0,0,1,1,3647.63290123831
"2372",16,8,0,18,0,6,24,2,2,2,3,1,20,0,12,0,9,21,16680.899338179
"2373",0,7,7,0,0,0,7,3,2,4,2,1,12,13,0,0,0,13,809.936213789201
"2374",0,4,0,0,4,0,4,6,2,3,3,0,0,0,0,0,0,0,1392.4217258017
"2375",2,7,7,0,1,1,9,3,2,5,2,1,2,0,0,2,1,3,809.936213789201
"2376",0,2,0,0,2,0,2,5,2,6,3,0,6,6,0,0,0,6,1176.34336501118
"2377",5,0,0,0,1,4,5,1,2,2,3,2,2,0,0,4,0,4,2848.43964196628
"2378",0,38,0,0,38,0,38,6,1,3,2,10,21,0,0,31,0,31,809.936213789201
"2379",1,0,0,0,0,1,1,3,2,6,2,2,1,0,0,2,1,3,809.936213789201
"2380",15,7,11,2,4,5,22,4,2,3,3,31,0,0,0,30,1,31,2874.08690746009
"2381",0,0,0,0,0,0,0,6,2,2,2,0,1,0,0,1,0,1,809.936213789201
"2382",0,0,0,0,0,0,0,5,2,2,3,3,0,0,0,0,3,3,1531.13061639774
"2383",3,8,0,0,7,4,11,2,1,4,2,4,1,4,0,0,1,5,1134.18570673158
"2384",0,0,0,0,0,0,0,2,1,3,1,0,1,1,0,0,0,1,809.936213789201
"2385",3,12,12,0,0,3,15,3,2,4,2,3,3,0,0,4,2,6,809.936213789201
"2386",3,2,0,0,2,3,5,2,2,5,5,3,0,0,0,2,1,3,825.988554460639
"2387",0,20,20,0,0,0,20,2,1,3,2,1,1,0,0,0,2,2,1159.64820332322
"2388",5,2,0,0,7,0,7,6,2,2,3,0,0,0,0,0,0,0,1856.74212521115
"2389",2,6,0,0,6,2,8,3,2,2,3,42,60,100,0,0,2,102,3811.31958404677
"2390",0,7,6,0,1,0,7,6,2,4,2,0,0,0,0,0,0,0,809.936213789201
"2391",0,4,0,0,4,0,4,6,2,6,2,1,0,0,0,1,0,1,809.936213789201
"2392",3,0,0,0,0,3,3,5,2,3,3,4,4,0,0,0,8,8,8531.77295730047
"2393",0,0,0,0,0,0,0,6,2,5,3,0,0,0,0,0,0,0,809.936213789201
"2394",1,1,0,0,1,1,2,5,1,8,2,2,0,0,0,0,2,2,809.936213789201
"2395",3,10,10,0,0,3,13,3,2,7,2,3,8,6,0,0,5,11,2001.54943221402
"2396",3,0,0,0,0,3,3,3,2,8,1,3,2,0,0,0,5,5,1469.52499942942
"2397",1,3,0,0,2,2,4,3,2,4,2,21,5,24,0,0,2,26,809.936213789201
"2398",0,0,0,0,0,0,0,3,1,3,1,1,0,0,0,0,1,1,809.936213789201
"2399",2,8,0,0,9,1,10,3,1,6,3,0,0,0,0,0,0,0,6000.36323974472
"2400",6,12,9,0,5,4,18,2,1,5,2,3,14,11,0,4,2,17,1465.2151548235
"2401",0,0,0,0,0,0,0,4,2,5,3,3,0,0,0,0,3,3,2053.43570054229
"2402",1,4,0,0,4,1,5,6,1,5,3,19,0,0,0,19,0,19,3604.14470903281
"2403",0,1,0,0,0,1,1,6,1,5,2,1,3,4,0,0,0,4,809.936213789201
"2404",1,0,0,0,0,1,1,6,1,4,3,0,0,0,0,0,0,0,904.935135187151
"2405",1,0,0,0,0,1,1,5,2,7,3,1,0,0,0,0,1,1,2862.23649091184
"2406",0,0,0,0,0,0,0,6,2,5,3,0,2,0,0,0,2,2,2445.78243891539
"2407",1,0,0,0,0,1,1,6,2,5,3,1,0,0,0,0,1,1,2143.17665206868
"2408",3,0,0,0,0,3,3,4,2,4,3,0,1,0,0,1,0,1,995.533825803492
"2409",0,0,0,0,0,0,0,5,2,3,3,0,0,0,0,0,0,0,4388.76459984856
"2410",1,1,0,0,1,1,2,6,2,6,3,1,0,0,0,0,1,1,2274.00231433091
"2411",117,6,0,0,95,28,123,5,1,4,3,3,2,0,0,0,5,5,5392.47612099774
"2412",0,3,3,0,0,0,3,5,2,5,3,1,4,0,0,4,1,5,1894.00697020883
"2413",2,13,13,0,0,2,15,2,2,5,2,2,18,15,0,1,4,20,809.936213789201
"2414",0,1,0,0,0,1,1,1,2,2,3,0,3,0,0,0,3,3,8314.78609634572
"2415",6,0,0,0,0,6,6,4,2,4,3,0,0,0,0,0,0,0,1695.66924972255
"2416",2,11,12,0,0,1,13,2,1,6,3,10,13,21,0,0,2,23,13640.3634370445
"2417",0,2,0,0,2,0,2,2,2,4,3,0,0,0,0,0,0,0,1894.14829320384
"2418",3,1,0,0,3,1,4,6,1,6,3,6,2,0,0,6,2,8,1243.18961943118
"2419",0,0,0,0,0,0,0,4,2,1,3,6,2,0,0,8,0,8,3062.25338808216
"2420",1,3,0,2,1,1,4,5,2,1,3,0,0,0,0,0,0,0,809.936213789201
"2421",0,0,0,0,0,0,0,6,2,5,3,0,0,0,0,0,0,0,1225.53055313346
"2422",12,6,18,0,0,0,18,2,2,7,3,13,7,17,0,3,0,20,4661.01790600045
"2423",0,0,0,0,0,0,0,5,2,3,3,0,0,0,0,0,0,0,809.936213789201
"2424",1,1,0,0,2,0,2,3,2,7,3,0,2,1,0,1,0,2,6409.99203551544
"2425",1,1,0,0,2,0,2,5,1,3,3,1,2,0,0,0,3,3,1681.21078173886
"2426",1,12,10,0,2,1,13,3,2,1,3,7,2,0,0,1,8,9,809.936213789201
"2427",1,0,0,0,0,1,1,5,1,6,3,0,5,4,0,0,1,5,988.646512888967
"2428",0,12,10,0,2,0,12,4,1,6,3,0,0,0,0,0,0,0,1705.01076937874
"2429",0,0,0,0,0,0,0,6,2,3,3,0,0,0,0,0,0,0,1388.28360902041
"2430",1,0,0,0,0,1,1,5,2,3,3,0,4,0,0,4,0,4,809.936213789201
"2431",9,0,0,0,7,2,9,6,1,1,3,0,5,0,0,5,0,5,809.936213789201
"2432",0,3,0,0,3,0,3,3,2,3,1,20,25,44,0,0,1,45,809.936213789201
"2433",1,5,5,0,0,1,6,5,2,7,3,0,2,0,0,1,1,2,5005.4063559142
"2434",0,0,0,0,0,0,0,4,1,4,3,9,0,9,0,0,0,9,3066.81523403721
"2435",0,0,0,0,0,0,0,4,1,8,3,0,1,0,0,0,1,1,4559.25459339874
"2436",1,2,0,0,0,3,3,4,2,2,3,0,0,0,0,0,0,0,2238.77237986413
"2437",0,1,0,0,1,0,1,5,1,5,3,0,0,0,0,0,0,0,7348.9678685135
"2438",3,1,0,0,3,1,4,5,2,5,3,0,1,0,0,1,0,1,1420.73835715648
"2439",0,4,4,0,0,0,4,4,2,4,3,0,30,30,0,0,0,30,4650.79550317321
"2440",59,70,70,0,0,59,129,3,2,3,3,3,2,1,0,0,4,5,809.936213789201
"2441",1,3,0,0,3,1,4,2,2,3,3,7,0,0,0,7,0,7,1373.0650307706
"2442",1,0,0,0,0,1,1,6,1,2,3,6,6,0,3,7,2,12,1046.09252289863
"2443",1,9,9,0,0,1,10,5,2,6,2,1,2,2,0,0,1,3,809.936213789201
"2444",4,0,0,0,0,4,4,4,2,6,3,14,72,0,72,12,2,86,2371.12732771525
"2445",0,2,0,0,0,2,2,5,1,3,3,0,4,0,0,4,0,4,3953.10961349839
"2446",0,2,0,0,2,0,2,6,2,4,3,0,0,0,0,0,0,0,2161.48409098075
"2447",86,116,180,0,20,2,202,5,2,4,3,2,0,0,0,2,0,2,1087.5922984128
"2448",9,11,18,0,0,2,20,6,2,7,2,3,9,10,0,0,2,12,926.70565288137
"2449",18,5,8,0,12,3,23,5,2,3,3,3,4,3,0,2,2,7,1124.00532897294
"2450",0,0,0,0,0,0,0,4,2,3,3,0,0,0,0,0,0,0,1656.89358861173
"2451",78,40,113,0,0,5,118,1,1,1,3,1,3,0,0,1,3,4,1181.18893211055
"2452",0,2,0,0,1,1,2,6,2,2,3,0,0,0,0,0,0,0,5820.12383473757
"2453",0,0,0,0,0,0,0,6,2,2,3,4,0,0,0,0,4,4,9324.65177569934
"2454",0,3,3,0,0,0,3,3,2,4,2,0,7,6,0,1,0,7,809.936213789201
"2455",1,0,0,0,0,1,1,6,2,6,2,1,1,0,0,0,2,2,809.936213789201
"2456",0,1,0,0,1,0,1,4,2,4,2,0,0,0,0,0,0,0,809.936213789201
"2457",2,4,0,0,0,6,6,6,1,4,2,0,2,0,0,2,0,2,1411.38304666755
"2458",1,0,0,0,0,1,1,5,2,6,2,0,0,0,0,0,0,0,809.936213789201
"2459",2,1,0,0,2,1,3,6,2,5,2,6,30,36,0,0,0,36,809.936213789201
"2460",0,0,0,0,0,0,0,4,2,4,3,0,0,0,0,0,0,0,809.936213789201
"2461",3,3,0,0,0,6,6,4,2,4,3,2,0,0,0,0,2,2,2720.34912135995
"2462",11,25,25,0,11,0,36,4,2,1,3,3,1,0,0,0,4,4,4402.83194561927
"2463",0,0,0,0,0,0,0,5,2,4,2,0,0,0,0,0,0,0,809.936213789201
"2464",0,0,0,0,0,0,0,5,2,5,3,0,0,0,0,0,0,0,1086.27639228777
"2465",0,3,0,0,3,0,3,5,2,1,2,0,0,0,0,0,0,0,809.936213789201
"2466",3,0,0,0,0,3,3,1,2,2,3,0,0,0,0,0,0,0,13424.235580973
"2467",6,2,2,2,0,4,8,3,2,4,1,1,14,8,0,0,7,15,1826.42283901571
"2468",1,1,0,0,0,2,2,5,2,3,3,5,5,2,0,5,3,10,1110.85635980537
"2469",28,0,0,0,0,28,28,5,2,5,3,3,0,0,0,0,3,3,1078.3805583646
"2470",6,0,0,0,4,2,6,4,1,6,2,2,1,0,0,0,3,3,911.910733543242
"2471",5,5,4,0,6,0,10,3,1,3,3,8,8,12,0,4,0,16,1689.07020269523
"2472",0,0,0,0,0,0,0,6,1,3,3,0,1,0,0,0,1,1,2657.93108778973
"2473",0,3,0,0,3,0,3,4,1,6,3,0,2,0,0,2,0,2,931.155318757915
"2474",1,0,0,0,0,1,1,2,1,4,2,1,0,0,0,0,1,1,809.936213789201
"2475",0,1,0,0,0,1,1,6,1,3,2,0,1,0,0,0,1,1,3521.7557702918
"2476",2,2,0,0,2,2,4,4,2,3,2,2,0,0,0,0,2,2,809.936213789201
"2477",1,2,0,0,0,3,3,5,1,5,1,1,2,0,0,0,3,3,809.936213789201
"2478",1,0,0,0,0,1,1,6,1,5,3,3,4,0,0,4,3,7,5046.81850295177
"2479",0,1,0,0,1,0,1,6,2,6,3,4,0,0,0,4,0,4,2995.93894490465
"2480",2,0,0,0,0,2,2,3,2,8,3,2,0,0,0,0,2,2,3778.54957098909
"2481",1,3,0,0,4,0,4,6,1,5,3,1,0,0,0,1,0,1,3712.40209984432
"2482",1,0,0,0,0,1,1,6,2,6,3,0,0,0,0,0,0,0,2995.93894490465
"2483",6,1,0,0,0,7,7,3,2,6,3,5,3,0,0,0,8,8,6470.792398295
"2484",4,4,0,0,1,7,8,2,1,2,2,3,3,0,0,0,6,6,809.936213789201
"2485",1,4,0,0,4,1,5,4,2,5,3,4,8,11,0,0,1,12,1535.80470191141
"2486",3,4,0,0,7,0,7,6,2,5,2,3,2,0,0,5,0,5,809.936213789201
"2487",1,0,0,0,1,0,1,4,1,1,2,1,0,0,0,1,0,1,809.936213789201
"2488",0,1,0,0,0,1,1,6,2,3,3,1,1,0,0,2,0,2,809.936213789201
"2489",16,6,20,0,0,2,22,3,2,3,3,1,2,0,0,2,1,3,1719.734772144
"2490",6,8,0,0,10,4,14,4,1,3,3,3,0,0,0,0,3,3,2814.85134546673
"2491",20,10,7,10,5,8,30,1,2,1,1,3,5,5,0,0,3,8,2119.51463733895
"2492",1,0,0,0,0,1,1,6,2,4,3,1,2,0,0,2,1,3,923.187678292714
"2493",0,0,0,0,0,0,0,4,2,2,3,0,0,0,0,0,0,0,2748.3053565888
"2494",0,119,118,0,0,1,119,2,2,3,2,0,13,13,0,0,0,13,809.936213789201
"2495",2,0,0,0,0,2,2,3,1,3,3,3,3,0,0,0,6,6,2648.14485073638
"2496",12,18,10,0,17,3,30,6,1,3,2,1,4,1,0,4,0,5,809.936213789201
"2497",1,1,0,0,0,2,2,4,1,3,3,66,0,65,0,0,1,66,1669.15211419738
"2498",3,4,0,0,4,3,7,3,2,6,3,3,0,0,0,0,3,3,1286.78691701655
"2499",5,2,0,0,0,7,7,3,2,5,3,7,14,2,12,3,4,21,2155.04746260842
"2500",6,0,0,0,0,6,6,2,2,8,2,3,0,0,0,0,3,3,4847.50493177657
"2501",1,0,0,0,0,1,1,5,1,4,3,0,3,3,0,0,0,3,3010.81102382928
"2502",0,4,0,0,3,1,4,6,2,5,2,9,5,0,0,13,1,14,809.936213789201
"2503",1,2,0,0,2,1,3,5,2,3,3,0,0,0,0,0,0,0,1226.87918869091
"2504",0,2,0,0,0,2,2,4,1,5,3,0,0,0,0,0,0,0,1096.80789117959
"2505",7,10,0,0,8,9,17,2,2,4,3,7,0,0,0,0,7,7,1173.668066277
"2506",0,29,20,0,8,1,29,2,2,3,3,2,10,6,0,4,2,12,1645.30488932408
"2507",0,0,0,0,0,0,0,5,2,1,3,0,0,0,0,0,0,0,809.936213789201
"2508",0,0,0,0,0,0,0,6,2,3,3,0,0,0,0,0,0,0,809.936213789201
"2509",25,65,0,90,0,0,90,4,2,6,3,0,2,0,0,0,2,2,1229.76888434235
"2510",2,15,0,14,1,2,17,2,1,4,4,0,0,0,0,0,0,0,3378.77745530002
"2511",4,0,0,0,0,4,4,3,1,4,3,0,0,0,0,0,0,0,2579.73825547427
"2512",23,13,32,0,0,4,36,2,1,5,2,4,4,0,0,0,8,8,809.936213789201
"2513",11,0,0,0,0,11,11,5,2,2,3,6,4,0,0,3,7,10,1801.69613495042
"2514",0,2,2,0,0,0,2,5,2,4,3,0,0,0,0,0,0,0,1432.87458524509
"2515",0,2,0,0,2,0,2,6,1,3,3,0,1,0,0,0,1,1,2657.93108778973
"2516",0,1,0,0,1,0,1,5,2,4,3,0,1,0,0,1,0,1,1092.29971527742
"2517",1,0,0,0,0,1,1,5,2,3,3,0,0,0,0,0,0,0,4401.8463796245
"2518",0,3,0,0,0,3,3,5,2,3,3,0,0,0,0,0,0,0,843.171366153125
"2519",2,6,0,0,8,0,8,4,2,5,3,2,20,15,0,7,0,22,2053.43570054229
"2520",2,17,12,0,0,7,19,2,2,6,4,25,24,45,0,0,4,49,3922.49429523288
"2521",1,0,0,0,0,1,1,6,1,3,3,0,0,0,0,0,0,0,2355.00991467365
"2522",1,3,0,0,1,3,4,3,2,6,3,5,5,0,0,0,10,10,1546.516340471
"2523",5,0,0,0,0,5,5,3,2,3,3,4,0,0,0,0,4,4,1142.99157288816
"2524",1,1,0,0,0,2,2,4,2,5,3,3,3,0,0,3,3,6,2023.38277724132
"2525",0,59,0,0,0,59,59,4,1,3,3,0,0,0,0,0,0,0,17969.0831520253
"2526",35,25,0,0,0,60,60,3,2,7,3,3,3,0,0,3,3,6,2202.65014223254
"2527",0,0,0,0,0,0,0,4,2,4,2,0,0,0,0,0,0,0,809.936213789201
"2528",1,0,0,0,0,1,1,2,1,8,2,0,1,0,0,1,0,1,3087.41777744786
"2529",19,25,15,0,25,4,44,2,1,4,1,9,6,6,0,6,3,15,847.668247879538
"2530",0,0,0,0,0,0,0,2,2,2,3,6,100,104,0,0,2,106,2737.75039594034
"2531",2,22,21,0,1,2,24,3,2,6,2,2,2,0,0,2,2,4,809.936213789201
"2532",16,0,0,0,0,16,16,4,1,6,2,3,0,0,0,0,3,3,1137.73064184347
"2533",0,3,0,0,3,0,3,3,2,5,2,0,2,0,0,2,0,2,809.936213789201
"2534",6,3,0,0,3,6,9,3,2,5,3,11,0,0,0,5,6,11,1335.32859979859
"2535",11,4,0,6,6,3,15,3,2,2,3,7,7,0,0,13,1,14,2892.89925935153
"2536",1,0,0,0,0,1,1,3,1,4,2,1,1,0,0,1,1,2,809.936213789201
"2537",3,2,0,0,4,1,5,2,1,5,1,5,4,0,0,8,1,9,809.936213789201
"2538",10,0,0,0,0,10,10,3,1,8,2,2,0,0,0,0,2,2,809.936213789201
"2539",2,0,0,0,0,2,2,2,1,4,2,3,13,14,0,0,2,16,809.936213789201
"2540",1,1,0,0,0,2,2,3,1,7,2,1,0,0,0,0,1,1,809.936213789201
"2541",6,10,14,0,2,0,16,2,2,3,1,3,10,12,0,0,1,13,809.936213789201
"2542",0,8,0,0,8,0,8,5,2,3,3,0,4,0,0,4,0,4,809.936213789201
"2543",0,0,0,0,0,0,0,2,1,3,3,0,0,0,0,0,0,0,4777.22675570511
"2544",3,0,0,0,0,3,3,3,2,1,3,4,0,0,0,0,4,4,1161.50059042737
"2545",1,1,0,0,0,2,2,1,2,4,3,3,0,0,0,0,3,3,16424.9637579144
"2546",29,5,0,0,34,0,34,3,1,4,3,9,5,0,0,14,0,14,1478.62200347552
"2547",0,1,0,0,0,1,1,5,2,3,3,0,2,0,0,2,0,2,5454.96805451765
"2548",0,0,0,0,0,0,0,4,1,6,2,3,3,0,0,6,0,6,809.936213789201
"2549",2,1,0,0,1,2,3,3,1,4,2,3,0,0,0,1,2,3,886.927208702793
"2550",0,0,0,0,0,0,0,4,1,6,2,0,0,0,0,0,0,0,809.936213789201
"2551",0,8,3,0,5,0,8,4,2,4,3,0,5,0,0,5,0,5,1288.79009733384
"2552",0,4,0,0,0,4,4,5,2,3,3,0,0,0,0,0,0,0,1384.69070396067
"2553",0,0,0,0,0,0,0,6,1,2,3,0,0,0,0,0,0,0,10635.0460864547
"2554",0,0,0,0,0,0,0,6,2,5,3,0,1,0,0,1,0,1,1383.16859556022
"2555",8,0,0,0,0,8,8,3,2,3,3,7,1,0,0,5,3,8,8604.94940159151
"2556",0,1,0,0,1,0,1,6,2,2,3,1,0,0,0,0,1,1,5156.81140056695
"2557",0,0,0,0,0,0,0,2,2,2,3,0,0,0,0,0,0,0,1263.28894124221
"2558",0,2,0,0,2,0,2,1,2,1,3,3,2,0,0,2,3,5,1305.12767482349
"2559",1,3,1,0,3,0,4,4,2,5,3,15,1,0,0,16,0,16,1281.68325759606
"2560",4,2,2,0,0,4,6,3,2,5,1,4,0,0,0,0,4,4,809.936213789201
"2561",0,0,0,0,0,0,0,6,1,6,3,0,0,0,0,0,0,0,3164.24844173441
"2562",3,0,0,0,2,1,3,2,1,3,2,1,4,0,0,1,4,5,809.936213789201
"2563",1,0,0,0,0,1,1,4,2,6,2,0,1,0,0,0,1,1,907.109870826519
"2564",0,0,0,0,0,0,0,5,1,4,3,0,1,0,0,0,1,1,822.480699324114
"2565",0,0,0,0,0,0,0,5,1,3,3,5,12,0,0,17,0,17,1139.37640135143
"2566",4,0,0,0,2,2,4,1,1,2,2,4,0,0,0,0,4,4,1023.71773684631
"2567",30,17,0,0,47,0,47,6,2,2,3,1,6,0,0,0,7,7,995.96204764139
"2568",5,0,0,0,5,0,5,1,2,1,3,25,5,0,0,10,20,30,3491.79204282341
"2569",4,0,0,0,0,4,4,3,2,3,3,10,5,15,0,0,0,15,6754.73495667596
"2570",0,1,0,0,1,0,1,6,1,3,3,0,4,0,0,0,4,4,14974.1013470493
"2571",0,2,0,0,0,2,2,6,2,3,3,4,5,0,0,9,0,9,4966.13685681627
"2572",3,0,0,0,0,3,3,3,2,6,3,5,0,0,0,2,3,5,1546.516340471
"2573",1,0,0,0,0,1,1,2,1,7,4,1,2,0,0,2,1,3,3569.56616388992
"2574",6,15,16,0,0,5,21,1,1,3,2,4,0,0,0,0,4,4,1237.36750344146
"2575",4,0,0,0,0,4,4,5,2,2,3,2,3,0,0,0,5,5,809.936213789201
"2576",1,2,0,0,2,1,3,3,1,4,3,7,6,12,0,0,1,13,1043.98734422462
"2577",4,0,0,0,2,2,4,2,2,3,3,1,0,0,0,0,1,1,3878.30188631425
"2578",0,0,0,0,0,0,0,4,2,6,3,0,0,0,0,0,0,0,1229.76888434235
"2579",0,0,0,0,0,0,0,5,2,1,3,0,0,0,0,0,0,0,809.936213789201
"2580",1,3,0,0,4,0,4,3,1,6,2,1,2,0,0,0,3,3,809.936213789201
"2581",0,0,0,0,0,0,0,6,1,3,2,6,6,12,0,0,0,12,809.936213789201
"2582",0,0,0,0,0,0,0,4,1,4,2,5,10,0,0,14,1,15,6794.09286874654
"2583",0,0,0,0,0,0,0,6,1,1,2,0,0,0,0,0,0,0,810.996179666715
"2584",10,19,26,0,0,3,29,2,2,2,3,3,6,3,0,0,6,9,1526.24271124057
"2585",0,0,0,0,0,0,0,2,2,4,2,0,1,0,0,0,1,1,1143.97446798787
"2586",0,3,0,0,0,3,3,3,1,4,3,8,32,0,0,22,18,40,961.501095186129
"2587",0,0,0,0,0,0,0,6,1,6,3,0,0,0,0,0,0,0,5049.48363008074
"2588",13,4,0,0,13,4,17,3,2,4,2,7,0,0,0,0,7,7,809.936213789201
"2589",2,0,0,0,0,2,2,6,2,4,3,1,1,0,0,0,2,2,2964.55677990486
"2590",2,2,0,0,0,4,4,2,1,1,2,0,2,0,0,2,0,2,809.936213789201
"2591",9,12,15,0,0,6,21,2,1,2,2,10,52,60,0,0,2,62,809.936213789201
"2592",2,0,0,0,0,2,2,4,2,8,2,1,0,0,0,0,1,1,1657.62156604971
"2593",1,0,0,0,0,1,1,4,2,8,2,1,1,0,0,1,1,2,1657.62156604971
"2594",0,0,0,0,0,0,0,2,1,8,2,0,1,0,0,0,1,1,2092.37948920278
"2595",0,6,1,0,3,2,6,5,2,4,3,0,3,1,0,1,1,3,2143.33019658152
"2596",5,0,0,0,0,5,5,3,1,5,4,0,0,0,0,0,0,0,2754.37646230517
"2597",1,2,0,0,2,1,3,2,2,8,1,1,1,0,0,1,1,2,3301.53977060525
"2598",0,0,0,0,0,0,0,3,2,2,3,5,42,44,0,0,3,47,5212.76440521851
"2599",1,2,0,0,2,1,3,2,2,3,3,1,4,0,0,4,1,5,1216.57847933349
"2600",0,15,10,0,5,0,15,2,1,3,3,0,0,0,0,0,0,0,4777.22675570511
"2601",4,0,0,0,0,4,4,3,2,3,3,4,0,0,0,0,4,4,809.936213789201
"2602",0,0,0,0,0,0,0,6,2,7,3,0,1,0,0,0,1,1,3028.37264337562
"2603",3,0,0,0,0,3,3,4,2,8,3,3,0,0,0,0,3,3,4743.41856594682
"2604",0,0,0,0,0,0,0,3,2,7,2,0,0,0,0,0,0,0,809.936213789201
"2605",0,0,0,0,0,0,0,6,2,5,2,0,2,0,0,2,0,2,809.936213789201
"2606",1,31,31,0,0,1,32,2,2,3,2,2,8,9,0,0,1,10,809.936213789201
"2607",3,2,0,0,3,2,5,5,2,6,3,1,1,0,0,1,1,2,1664.91065461176
"2608",3,2,0,0,2,3,5,5,2,6,3,0,2,0,0,2,0,2,1677.10102462887
"2609",1,0,0,0,0,1,1,4,1,3,3,7,3,0,0,10,0,10,2602.74990552233
"2610",0,6,0,0,6,0,6,5,2,5,3,0,54,49,0,5,0,54,809.936213789201
"2611",3,0,0,0,0,3,3,4,1,3,3,0,1,0,0,1,0,1,3135.66531033458
"2612",0,0,0,0,0,0,0,6,2,4,3,0,0,0,0,0,0,0,2161.48409098075
"2613",0,2,0,0,0,2,2,3,1,4,3,0,0,0,0,0,0,0,2518.50193159734
"2614",0,5,0,0,5,0,5,2,2,4,3,6,6,12,0,0,0,12,1177.1664692612
"2615",1,0,0,0,0,1,1,4,1,4,2,9,4,2,0,10,1,13,853.045742953864
"2616",1,0,0,0,0,1,1,2,2,3,3,0,1,0,0,1,0,1,1373.0650307706
"2617",0,5,3,0,2,0,5,2,2,4,4,0,2,2,0,0,0,2,848.940683399851
"2618",27,47,29,0,45,0,74,6,2,6,5,9,8,0,0,17,0,17,944.785716493801
"2619",0,0,0,0,0,0,0,2,2,4,3,0,15,0,0,15,0,15,1416.67053614178
"2620",0,0,0,0,0,0,0,5,2,1,3,16,16,0,2,30,0,32,2088.09776937527
"2621",0,0,0,0,0,0,0,5,2,6,3,0,0,0,0,0,0,0,1248.93090360578
"2622",0,35,33,0,0,2,35,5,2,4,3,0,11,0,0,10,1,11,809.936213789201
"2623",0,8,5,0,3,0,8,5,2,1,3,1,1,1,0,1,0,2,1923.11554657894
"2624",0,1,0,0,0,1,1,5,1,5,2,2,0,0,0,0,2,2,809.936213789201
"2625",4,1,0,0,5,0,5,3,1,5,2,0,9,0,0,9,0,9,809.936213789201
"2626",2,15,17,0,0,0,17,5,2,6,3,4,40,43,0,0,1,44,1039.17941567182
"2627",1,2,0,0,2,1,3,5,2,4,2,1,5,0,0,5,1,6,809.936213789201
"2628",7,8,14,0,1,0,15,2,2,3,2,2,6,3,0,5,0,8,809.936213789201
"2629",0,1,0,0,0,1,1,6,2,1,3,0,0,0,0,0,0,0,809.936213789201
"2630",3,0,0,0,0,3,3,4,2,4,2,3,2,0,0,0,5,5,2553.3998683245
"2631",2,1,0,0,0,3,3,5,2,7,3,3,1,0,0,1,3,4,2343.53517549011
"2632",2,2,2,0,0,2,4,3,1,1,3,1,1,0,0,0,2,2,7073.57032950651
"2633",0,0,0,0,0,0,0,5,2,3,3,1,4,5,0,0,0,5,1520.40444029134
"2634",4,56,60,0,0,0,60,4,2,4,3,5,7,10,0,2,0,12,809.936213789201
"2635",0,0,0,0,0,0,0,4,2,3,3,3,0,0,0,0,3,3,1447.57865162333
"2636",0,0,0,0,0,0,0,5,1,3,3,1,1,0,0,0,2,2,10330.1583036489
"2637",0,1,0,0,1,0,1,5,2,2,3,0,0,0,0,0,0,0,1176.82397733119
"2638",0,12,7,0,0,5,12,2,2,4,3,0,5,2,0,0,3,5,24936.652277822
"2639",3,1,0,0,0,4,4,6,2,3,3,5,3,0,0,6,2,8,1668.49946806734
"2640",1,3,0,0,0,4,4,1,2,2,3,2,0,0,0,0,2,2,2523.80644065469
"2641",0,0,0,0,0,0,0,6,2,6,3,0,0,0,0,0,0,0,1413.23637914587
"2642",0,1,0,0,0,1,1,6,2,3,3,0,0,0,0,0,0,0,809.936213789201
"2643",0,0,0,0,0,0,0,6,2,3,3,0,0,0,0,0,0,0,1282.40540627784
"2644",2,0,0,0,0,2,2,6,2,4,1,4,3,0,0,5,2,7,9034.42286228538
"2645",3,3,0,0,0,6,6,2,1,8,1,5,4,0,0,2,7,9,7599.75610611797
"2646",1,1,0,0,1,1,2,2,2,4,2,1,0,0,0,0,1,1,809.936213789201
"2647",8,0,4,0,0,4,8,2,2,2,1,11,70,81,0,0,0,81,1136.75132685043
"2648",5,0,2,0,1,2,5,3,1,6,1,6,6,0,7,0,5,12,1553.33763768268
"2649",5,2,0,0,2,5,7,3,2,3,1,5,1,0,0,1,5,6,1827.80533716222
"2650",1,2,0,0,2,1,3,2,2,7,1,0,2,0,0,2,0,2,3705.13575037033
"2651",1,0,0,0,1,0,1,2,2,8,1,2,20,0,0,21,1,22,4685.30118539717
"2652",3,0,0,0,0,3,3,4,1,8,2,6,9,0,0,13,2,15,1160.2025402226
"2653",0,8,0,0,8,0,8,5,2,3,3,0,2,0,0,0,2,2,36706.1476804084
"2654",3,0,0,0,0,3,3,2,2,3,2,3,0,0,0,0,3,3,42596.4877901681
"2655",1,0,0,0,0,1,1,4,2,2,2,1,1,0,0,0,2,2,5266.91464081887
"2656",0,1,0,0,1,0,1,6,1,1,2,0,0,0,0,0,0,0,2142.67667810656
"2657",2,0,0,0,0,2,2,3,2,3,2,15,13,26,0,0,2,28,4136.58145763622
"2658",16,0,0,0,0,16,16,5,2,2,3,3,3,0,0,3,3,6,25590.0182766846
"2659",3,6,0,0,5,4,9,4,2,5,2,1,2,2,0,0,1,3,2277.31824711767
"2660",2,4,0,0,4,2,6,2,2,6,2,3,3,0,0,0,6,6,8290.06421664688
"2661",1,2,0,0,0,3,3,6,2,3,2,0,3,0,0,0,3,3,1180.65958589214
"2662",50,130,180,0,0,0,180,5,2,5,2,0,74,74,0,0,0,74,1610.74975645751
"2663",2,0,0,0,0,2,2,4,1,7,2,2,0,0,0,0,2,2,6233.8662697371
"2664",8,2,0,0,2,8,10,2,2,8,4,1,15,0,0,15,1,16,28195.0969116797
"2665",0,1,0,0,1,0,1,4,2,5,3,1,0,0,0,0,1,1,10641.6492373983
"2666",0,9,6,0,0,3,9,3,1,4,4,3,2,0,0,2,3,5,54232.6996392354
"2667",0,0,0,0,0,0,0,6,2,3,2,0,3,0,0,3,0,3,3312.39425842496
"2668",0,0,0,0,0,0,0,6,1,2,2,0,1,0,0,0,1,1,2962.61093418611
"2669",1,1,0,0,1,1,2,6,2,4,2,0,2,0,0,1,1,2,6198.17375605418
"2670",9,0,0,0,9,0,9,6,2,4,2,1,4,0,0,4,1,5,1832.76148632373
"2671",1,0,0,0,0,1,1,3,2,3,2,1,1,0,0,0,2,2,2147.21028716276
"2672",2,9,0,0,9,2,11,4,2,8,1,2,1,0,0,1,2,3,32856.0305354442
"2673",4,0,0,0,4,0,4,5,2,7,2,0,2,2,0,0,0,2,4262.54467982813
"2674",5,12,5,0,5,7,17,5,2,3,2,1,3,0,0,0,4,4,2650.46292000127
"2675",1,0,0,0,0,1,1,4,1,8,1,3,2,0,0,3,2,5,21971.1804218286
"2676",5,12,0,0,11,6,17,4,1,6,2,7,4,0,0,8,3,11,8130.06820580881
"2677",15,18,30,0,0,3,33,2,2,2,3,2,0,0,0,0,2,2,10880.2958079837
"2678",2,3,0,0,5,0,5,6,2,6,2,0,2,0,0,2,0,2,4120.20170642735
"2679",0,7,5,0,0,2,7,5,1,7,1,0,1,0,0,0,1,1,42145.963965179
"2680",3,11,0,11,0,3,14,2,1,6,2,4,10,0,0,10,4,14,4044.85170603751
"2681",5,10,13,0,0,2,15,4,1,2,1,12,0,10,0,0,2,12,8636.52950125711
"2682",64,8,69,0,0,3,72,2,2,5,2,36,23,56,0,0,3,59,4900.6155792289
"2683",1,0,0,0,0,1,1,4,2,5,3,0,0,0,0,0,0,0,7959.09749235006
"2684",14,0,12,0,0,2,14,5,2,5,2,2,0,0,0,1,1,2,4091.67853773672
"2685",22,2,0,0,20,4,24,4,1,3,2,1,0,0,0,0,1,1,30079.8118854768
"2686",0,7,5,0,2,0,7,2,2,5,2,0,0,0,0,0,0,0,2784.8873734573
"2687",0,0,0,0,0,0,0,4,2,5,2,0,0,0,0,0,0,0,3058.04969243728
"2688",3,6,6,0,0,3,9,2,1,5,2,7,17,10,0,11,3,24,7134.08476641625
"2689",2,4,0,0,3,3,6,2,1,5,3,3,1,0,0,2,2,4,29166.357526581
"2690",1,2,0,0,1,2,3,5,2,4,2,20,28,0,46,0,2,48,1946.60318649901
"2691",1,0,0,0,0,1,1,4,2,3,2,1,1,0,0,0,2,2,4300.11975856202
"2692",3,0,0,0,2,1,3,6,2,4,2,3,0,0,0,0,3,3,5204.96290813345
"2693",2,3,0,0,5,0,5,5,2,4,3,2,1,0,0,0,3,3,6832.7137283789
"2694",11,41,50,0,0,2,52,2,1,4,2,1,2,0,0,2,1,3,7275.50409316019
"2695",35,0,30,0,5,0,35,6,2,2,2,7,0,0,0,5,2,7,19757.9403714556
"2696",0,0,0,0,0,0,0,6,1,8,2,1,0,0,0,0,1,1,14576.2495696984
"2697",1,0,0,0,0,1,1,4,2,7,2,1,2,0,0,0,3,3,4179.05739485878
"2698",2,0,0,0,2,0,2,6,1,6,2,0,1,0,0,0,1,1,2741.75490326223
"2699",11,15,22,0,0,4,26,4,1,6,4,3,0,0,0,0,3,3,8193.29411432159
"2700",3,2,0,0,0,5,5,6,2,6,2,2,2,0,0,3,1,4,3386.52536142467
"2701",1,19,18,0,0,2,20,2,1,6,2,1,55,55,0,0,1,56,9995.0049600795
"2702",3,0,0,0,0,3,3,3,2,5,2,3,1,0,0,1,3,4,3845.70131798034
"2703",0,0,0,0,0,0,0,6,1,7,2,0,0,0,0,0,0,0,13222.2550744699
"2704",9,0,5,0,0,4,9,2,2,3,1,3,0,0,0,0,3,3,12908.6742032816
"2705",3,8,8,0,0,3,11,3,2,6,2,4,9,8,0,0,5,13,10383.1292598524
"2706",0,4,3,0,0,1,4,4,1,3,3,0,3,2,0,0,1,3,114167.841688373
"2707",10,20,3,0,24,3,30,5,2,6,2,4,4,4,0,0,4,8,4794.8865168661
"2708",1,0,0,0,0,1,1,5,2,6,2,1,0,0,0,0,1,1,2979.90376562348
"2709",10,0,0,0,0,10,10,5,2,8,2,2,0,0,0,0,2,2,11715.1794113782
"2710",2,7,0,0,2,7,9,2,2,6,2,2,0,0,0,0,2,2,8290.06421664688
"2711",21,4,0,0,25,0,25,6,2,8,2,2,30,0,0,31,1,32,13256.3920746781
"2712",0,12,0,0,12,0,12,6,2,5,2,1,0,0,0,0,1,1,1817.23827748251
"2713",3,0,0,0,3,0,3,6,2,5,2,0,2,0,0,2,0,2,5113.54163585629
"2714",0,1,0,0,0,1,1,5,2,5,3,0,0,0,0,0,0,0,15840.8358376312
"2715",11,10,18,0,0,3,21,3,2,6,2,3,0,0,0,0,3,3,5937.37437966234
"2716",1,0,0,0,0,1,1,5,1,5,2,1,0,0,0,0,1,1,3845.63404470275
"2717",3,3,3,0,0,3,6,5,2,5,2,0,5,5,0,0,0,5,5157.09643989253
"2718",7,2,0,0,8,1,9,6,1,7,2,5,0,0,0,0,5,5,12836.6807760752
"2719",1,8,9,0,0,0,9,5,2,3,3,2,2,0,0,4,0,4,10261.2039587774
"2720",2,3,2,0,2,1,5,2,2,4,2,3,4,3,0,0,4,7,4942.47760691647
"2721",3,20,20,0,1,2,23,1,2,3,3,1,18,18,0,0,1,19,15268.8256114184
"2722",2,2,2,0,0,2,4,3,2,5,4,2,5,5,0,0,2,7,5353.2883520799
"2723",2,5,5,0,1,1,7,6,2,6,2,0,3,0,0,3,0,3,7894.7917655796
"2724",2,3,0,0,2,3,5,3,2,6,1,0,1,0,0,1,0,1,14113.0283402454
"2725",2,0,1,0,0,1,2,5,2,7,2,1,0,0,0,0,1,1,15920.4628050495
"2726",1,2,0,0,0,3,3,6,1,4,2,1,0,0,0,0,1,1,2723.81393962174
"2727",1,2,0,0,3,0,3,6,2,3,2,0,0,0,0,0,0,0,3312.39425842496
"2728",3,1,0,0,4,0,4,5,1,6,2,1,0,0,0,0,1,1,8856.0872391876
"2729",3,2,0,0,0,5,5,3,2,6,2,5,2,0,0,4,3,7,5937.37437966234
"2730",4,12,12,0,3,1,16,2,2,5,2,3,0,2,0,0,1,3,8622.54772335717
"2731",2,3,0,0,3,2,5,6,1,5,2,2,0,0,0,0,2,2,3018.31035089984
"2732",5,0,0,0,0,5,5,2,2,3,2,8,5,0,0,10,3,13,8932.65957938855
"2733",1,0,0,0,0,1,1,6,1,3,2,1,4,0,0,4,1,5,3067.62324750889
"2734",1,0,0,0,0,1,1,6,1,8,2,2,2,0,0,3,1,4,5898.82327973893
"2735",10,5,0,0,15,0,15,6,2,8,2,1,3,0,0,3,1,4,13256.3920746781
"2736",31,21,30,0,20,2,52,2,2,5,2,1,1,0,0,0,2,2,5369.56385861484
"2737",5,1,0,0,5,1,6,2,2,3,2,3,7,0,0,9,1,10,6001.00949608116
"2738",1,2,0,0,2,1,3,5,2,3,1,5,7,11,0,0,1,12,3645.22340714112
"2739",0,0,0,0,0,0,0,5,2,5,2,0,0,0,0,0,0,0,26515.6634346735
"2740",2,0,0,0,0,2,2,3,1,5,1,5,0,0,0,3,2,5,11119.0331211837
"2741",8,60,65,0,0,3,68,4,2,4,2,0,86,86,0,0,0,86,1911.04064319516
"2742",0,0,0,0,0,0,0,2,1,3,2,0,7,0,0,4,3,7,10917.4962098121
"2743",5,3,0,0,1,7,8,2,1,3,3,1,0,0,0,0,1,1,95575.1299620786
"2744",1,0,0,0,0,1,1,5,1,5,2,0,0,0,0,0,0,0,1556.27931037946
"2745",2,0,0,0,1,1,2,3,2,4,1,4,9,11,0,0,2,13,2726.07379330735
"2746",4,180,94,90,0,0,184,5,2,3,2,0,1,0,0,0,1,1,2681.83588276758
"2747",11,20,26,0,3,2,31,1,2,4,2,17,12,28,0,0,1,29,9916.85029508486
"2748",1,1,0,0,0,2,2,6,1,7,2,0,2,0,0,2,0,2,5194.8418579428
"2749",1,3,1,0,1,2,4,6,1,6,2,10,0,0,0,10,0,10,6774.99593286056
"2750",3,3,0,0,3,3,6,3,2,7,2,3,0,0,0,0,3,3,8456.39853883997
"2751",2,0,0,0,0,2,2,6,2,6,2,5,2,0,0,5,2,7,12500.5929016484
"2752",0,4,0,0,3,1,4,5,2,1,1,0,2,0,0,0,2,2,4560.03764738884
"2753",1,5,1,0,4,1,6,5,1,6,2,1,3,0,0,3,1,4,14614.8739099398
"2754",1,4,4,0,0,1,5,2,2,6,1,4,2,0,0,5,1,6,38691.5838687492
"2755",0,4,0,0,4,0,4,6,1,4,2,0,0,0,0,0,0,0,5079.74491193458
"2756",0,22,12,0,10,0,22,6,1,3,2,0,0,0,0,0,0,0,3159.76518840703
"2757",0,0,0,0,0,0,0,5,1,5,2,1,1,0,0,1,1,2,10806.2995471048
"2758",0,1,0,0,0,1,1,5,2,1,3,2,1,0,0,2,1,3,7816.47354828751
"2759",0,0,0,0,0,0,0,5,1,1,2,0,1,0,0,0,1,1,1787.03294141749
"2760",0,0,0,0,0,0,0,5,1,2,2,1,0,0,0,0,1,1,2043.81146039821
"2761",1,3,0,0,3,1,4,5,1,7,2,1,2,0,0,2,1,3,16779.7539572138
"2762",7,0,0,0,0,7,7,2,2,4,5,11,1,0,0,1,11,12,47085.182234547
"2763",4,1,0,0,2,3,5,3,2,5,2,8,1,0,0,6,3,9,6754.14107988722
"2764",0,23,20,0,0,3,23,4,2,4,2,1,0,0,0,0,1,1,8514.70834306674
"2765",1,0,0,0,0,1,1,6,2,6,2,3,1,0,0,3,1,4,10828.0040330838
"2766",13,20,0,0,30,3,33,4,2,2,2,28,3,0,0,28,3,31,4918.99397634158
"2767",8,0,0,0,8,0,8,6,2,6,2,5,2,0,0,2,5,7,3371.93066147568
"2768",1,0,0,0,0,1,1,2,2,7,2,1,0,0,0,0,1,1,7337.91723725269
"2769",3,80,80,0,2,1,83,5,1,5,3,5,6,0,0,10,1,11,21217.1621567363
"2770",1,3,0,0,3,1,4,6,2,6,2,1,1,0,0,1,1,2,5425.68691346121
"2771",0,1,0,0,1,0,1,6,2,3,2,0,0,0,0,0,0,0,1177.15080176817
"2772",2,0,0,0,0,2,2,3,2,6,2,2,0,0,0,0,2,2,7914.92774866825
"2773",2,1,0,0,3,0,3,5,2,5,2,0,16,15,0,1,0,16,2584.11343216072
"2774",31,1,5,26,0,1,32,6,2,5,2,0,2,0,0,2,0,2,1882.51546985683
"2775",20,8,0,0,17,11,28,6,1,6,2,10,0,0,0,0,10,10,6774.99593286056
"2776",3,3,0,0,5,1,6,5,2,6,3,1,0,0,0,0,1,1,33443.5299610721
"2777",3,0,0,0,0,3,3,3,2,4,3,4,2,0,0,2,4,6,13555.3184140007
"2778",3,1,1,0,0,3,4,3,2,3,2,6,2,2,0,5,1,8,12966.4836107406
"2779",5,0,0,0,5,0,5,5,2,8,2,1,0,0,0,0,1,1,7280.69519896322
"2780",0,3,0,0,3,0,3,6,2,1,2,0,2,0,0,2,0,2,1575.97950515443
"2781",0,0,0,0,0,0,0,1,1,6,1,3,1,0,0,1,3,4,300801.53127473
"2782",4,2,0,0,0,6,6,5,1,8,2,4,2,0,0,5,1,6,19053.6701554764
"2783",58,27,40,0,30,15,85,5,1,5,3,16,3,15,0,0,4,19,21096.6456151419
"2784",1,6,0,0,6,1,7,5,1,2,2,1,0,0,0,0,1,1,3027.73737679188
"2785",0,1,0,0,1,0,1,1,2,7,5,0,0,0,0,0,0,0,36789.0111662309
"2786",1,24,24,0,0,1,25,5,2,6,2,0,7,0,0,6,1,7,9569.12025535299
"2787",24,3,0,0,24,3,27,4,1,6,2,11,29,30,0,6,4,40,10711.1535502902
"2788",3,5,1,0,5,2,8,4,2,7,2,5,5,0,0,0,10,10,8347.11484932104
"2789",0,0,0,0,0,0,0,5,2,1,2,0,1,0,0,0,1,1,1392.75321275434
"2790",2,2,2,0,0,2,4,4,2,3,2,1,0,0,0,0,1,1,2373.66839162
"2791",3,2,0,0,3,2,5,5,2,8,2,1,3,0,0,3,1,4,73286.3779486155
"2792",4,25,24,0,0,5,29,3,2,5,2,1,1,0,0,1,1,2,3845.70131798034
"2793",4,12,10,0,4,2,16,6,2,8,2,1,3,0,0,3,1,4,13256.3920746781
"2794",1,181,180,0,0,2,182,5,2,5,2,1,4,0,0,3,2,5,3099.4165736985
"2795",0,0,0,0,0,0,0,5,2,6,2,5,0,0,0,0,5,5,29995.2611186201
"2796",0,1,0,0,0,1,1,6,1,3,2,1,0,0,0,0,1,1,8321.16992223522
"2797",36,512,545,0,2,1,548,4,2,7,2,31,250,280,0,0,1,281,8057.67434776115
"2798",4,4,2,2,2,2,8,3,1,3,3,2,1,0,0,0,3,3,30981.4436746832
"2799",49,1,32,0,17,1,50,6,1,3,2,0,0,0,0,0,0,0,5042.3292884723
"2800",2,0,0,0,2,0,2,6,1,3,2,2,1,0,0,1,2,3,4504.94754983793
"2801",9,0,5,0,0,4,9,4,1,3,1,4,0,4,0,0,0,4,15522.1105481629
"2802",0,0,0,0,0,0,0,6,1,4,2,1,1,0,0,1,1,2,40297.4030952876
"2803",2,0,0,0,0,2,2,2,1,1,2,1,1,0,0,2,0,2,3507.37683338021
"2804",0,0,0,0,0,0,0,6,2,2,2,0,0,0,0,0,0,0,1972.71049978535
"2805",1,3,0,0,2,2,4,5,2,4,2,3,0,0,0,0,3,3,5477.56261024993
"2806",1,5,0,0,4,2,6,5,1,1,2,1,0,0,0,0,1,1,3130.7027281182
"2807",2,2,0,0,0,4,4,5,2,6,2,2,2,0,0,1,3,4,11047.2508482266
"2808",0,6,6,0,0,0,6,5,1,7,2,0,21,19,0,0,2,21,10208.3700571296
"2809",3,20,0,0,22,1,23,6,1,4,2,1,4,0,0,0,5,5,41507.8127951652
"2810",1,1,0,0,1,1,2,5,2,3,2,1,0,0,0,0,1,1,2011.77624943987
"2811",3,8,0,0,5,6,11,6,2,7,2,1,0,0,0,0,1,1,4802.52510544808
"2812",3,3,0,0,6,0,6,6,2,6,2,0,4,0,0,4,0,4,5425.68691346121
"2813",1,0,0,0,0,1,1,6,2,4,2,4,0,0,0,0,4,4,22171.9675539578
"2814",5,3,0,0,7,1,8,6,2,3,2,25,2,11,8,0,8,27,5306.9185262501
"2815",0,1,0,0,0,1,1,5,2,3,2,0,0,0,0,0,0,0,1673.90882979965
"2816",1,0,0,0,0,1,1,6,1,3,2,1,0,0,0,0,1,1,5042.3292884723
"2817",71,0,9,0,60,2,71,1,2,2,4,7,71,41,0,35,2,78,21658.9623497739
"2818",0,20,10,0,10,0,20,1,1,3,2,1,1,0,0,0,2,2,5885.76585291289
"2819",0,1,0,0,1,0,1,2,1,2,5,0,1,0,0,1,0,1,20302.0897298462
"2820",1,0,0,0,0,1,1,1,2,3,2,1,1,0,0,1,1,2,4869.80082454073
"2821",18,55,70,0,2,1,73,2,2,2,2,14,30,44,0,0,0,44,5002.57485948115
"2822",1,17,11,0,6,1,18,1,2,1,2,4,13,10,0,0,7,17,5338.20962163913
"2823",1,2,0,0,2,1,3,3,1,6,2,2,1,0,0,0,3,3,7816.04088078306
"2824",5,10,0,0,12,3,15,2,2,6,2,2,10,11,0,0,1,12,12174.3452397911
"2825",1,3,0,0,3,1,4,4,2,8,2,1,5,0,0,5,1,6,8590.3967042111
"2826",1,1,0,0,0,2,2,6,2,6,2,0,5,0,0,5,0,5,2805.63234071772
"2827",2,4,0,0,4,2,6,4,1,2,5,3,15,0,0,18,0,18,20185.9242486211
"2828",1,1,0,0,0,2,2,5,1,1,2,0,2,0,0,2,0,2,8624.59142594342
"2829",0,0,0,0,0,0,0,6,2,6,2,1,1,0,0,1,1,2,9488.30323702129
"2830",1,11,10,0,0,2,12,5,2,4,2,1,10,10,0,0,1,11,5477.56261024993
"2831",0,1,0,0,1,0,1,5,2,4,2,0,2,0,0,1,1,2,1624.50909950583
"2832",2,1,0,0,0,3,3,5,1,4,2,1,0,0,0,0,1,1,3921.86624481139
"2833",1,1,0,0,0,2,2,5,2,6,2,0,0,0,0,0,0,0,6317.13836074267
"2834",10,2,0,2,0,10,12,2,1,4,2,1,2,0,0,0,3,3,157543.618637656
"2835",3,2,2,0,0,3,5,3,2,7,2,2,1,0,1,0,2,3,8456.39853883997
"2836",3,0,0,0,0,3,3,3,2,6,2,4,11,0,0,12,3,15,3689.93180748646
"2837",0,19,6,0,13,0,19,4,2,5,2,1,1,0,0,1,1,2,14978.6070367954
"2838",3,0,0,0,0,3,3,6,1,2,2,0,0,0,0,0,0,0,1198.93105999747
"2839",25,0,0,0,0,25,25,3,2,3,2,2,4,0,0,3,3,6,4356.41860685535
"2840",3,7,0,0,7,3,10,2,2,4,2,3,0,0,0,0,3,3,5415.4317352694
"2841",19,43,0,61,0,1,62,5,2,8,2,3,7,6,0,0,4,10,7280.69519896322
"2842",4,0,1,0,3,0,4,6,1,4,2,52,62,6,0,106,2,114,2055.70832184065
"2843",3,0,0,0,0,3,3,5,2,4,2,30,0,0,0,0,30,30,7216.54637015174
"2844",2,5,6,0,0,1,7,3,2,4,2,2,0,0,0,0,2,2,14349.6762474312
"2845",6,5,11,0,0,0,11,2,2,3,2,1,4,4,0,1,0,5,2902.7120565884
"2846",0,2,0,0,2,0,2,6,2,2,2,0,0,0,0,0,0,0,3936.92404085955
"2847",1,0,0,0,0,1,1,1,2,2,2,1,0,0,0,0,1,1,3443.3886601539
"2848",1,0,0,0,0,1,1,6,1,2,2,7,3,0,0,3,7,10,18926.6303577181
"2849",0,5,4,0,0,1,5,3,2,4,2,0,4,3,0,0,1,4,7740.39822261151
"2850",1,0,0,0,0,1,1,6,2,6,2,1,0,0,0,0,1,1,5425.68691346121
"2851",5,20,22,0,0,3,25,4,2,8,2,3,15,15,0,0,3,18,8590.3967042111
"2852",4,16,0,0,16,4,20,5,1,8,2,8,0,0,0,0,8,8,94719.0654981544
"2853",1,2,0,0,2,1,3,2,1,5,2,0,27,25,0,0,2,27,11773.1167848749
"2854",1,0,0,0,0,1,1,6,2,6,2,0,0,0,0,0,0,0,9829.13349763351
"2855",1,2,1,0,0,2,3,2,2,6,3,1,0,0,0,0,1,1,18006.1929351556
"2856",1,10,10,0,0,1,11,3,2,4,3,2,0,0,0,0,2,2,11278.7727712061
"2857",4,11,12,0,0,3,15,2,1,6,2,1,5,0,0,4,2,6,27112.2389993442
"2858",2,0,0,0,0,2,2,6,2,4,2,0,50,0,0,50,0,50,13838.9722134304
"2859",7,0,0,0,5,2,7,5,2,6,3,25,0,21,0,0,4,25,22078.0385655152
"2860",0,0,0,0,0,0,0,3,1,4,2,0,0,0,0,0,0,0,5893.77531391874
"2861",1,4,0,0,4,1,5,4,2,4,2,2,2,0,0,3,1,4,1985.5882587512
"2862",1,0,0,0,0,1,1,6,1,1,2,1,0,0,0,0,1,1,2457.18452146685
"2863",0,0,0,0,0,0,0,5,2,3,2,0,0,0,0,0,0,0,3340.60771459491
"2864",5,0,0,0,0,5,5,3,2,2,2,7,7,8,0,1,5,14,8855.89397006005
"2865",2,0,0,0,2,0,2,5,1,7,2,1,2,0,0,0,3,3,10208.3700571296
"2866",13,1,0,0,3,11,14,3,2,2,2,32,8,0,0,33,7,40,23764.0454916444
"2867",1,3,3,0,0,1,4,1,1,1,2,3,3,0,0,5,1,6,2903.73035779999
"2868",0,0,0,0,0,0,0,6,2,3,2,1,1,0,0,1,1,2,1177.15080176817
"2869",1,0,0,0,0,1,1,4,2,5,3,62,56,91,0,25,2,118,6622.40821929893
"2870",25,82,84,0,20,3,107,3,1,6,2,12,10,0,0,19,3,22,44957.8158927452
"2871",2,1,0,0,0,3,3,5,2,6,2,2,3,0,0,3,2,5,5233.7353996827
"2872",0,1,1,0,0,0,1,5,2,3,1,5,13,15,0,3,0,18,4121.77477939063
"2873",0,0,0,0,0,0,0,6,2,5,2,0,0,0,0,0,0,0,12031.2267546616
"2874",11,28,38,0,0,1,39,6,1,7,2,1,2,0,0,2,1,3,8341.97581308964
"2875",0,0,0,0,0,0,0,3,1,5,2,7,0,2,2,1,2,7,9170.04056811148
"2876",2,0,1,0,0,1,2,5,1,6,2,1,0,0,0,0,1,1,5387.81534141529
"2877",4,1,1,0,1,3,5,4,2,5,2,5,1,0,0,2,4,6,11288.099216268
"2878",4,16,9,3,0,8,20,3,2,3,2,3,18,15,0,0,6,21,2273.56514406552
"2879",3,0,0,0,1,2,3,6,2,4,2,14,0,0,0,14,0,14,2949.04937561514
"2880",3,6,0,0,5,4,9,6,2,6,2,0,2,0,0,2,0,2,3371.93066147568
"2881",7,7,0,0,8,6,14,1,2,4,2,0,4,2,0,1,1,4,4732.43490666016
"2882",13,16,0,18,6,5,29,4,2,5,4,0,6,0,6,0,0,6,12760.1820793906
"2883",4,188,188,0,0,4,192,5,2,1,2,17,106,117,0,2,4,123,2205.28184175948
"2884",0,2,0,0,0,2,2,6,2,4,2,0,1,0,0,1,0,1,5157.22252003931
"2885",15,8,23,0,0,0,23,4,2,3,3,0,0,0,0,0,0,0,22070.2038885602
"2886",2,1,1,0,0,2,3,4,2,3,2,2,1,0,0,1,2,3,1975.02305778553
"2887",3,0,0,0,0,3,3,3,1,1,2,4,0,0,0,0,4,4,30182.81239633
"2888",2,1,0,1,0,2,3,2,2,3,2,2,0,0,0,0,2,2,5585.41997029437
"2889",3,1,0,0,2,2,4,5,2,5,2,202,0,0,0,0,202,202,19428.2536085592
"2890",0,6,0,0,6,0,6,2,2,4,3,3,4,0,0,4,3,7,36618.7030848179
"2891",0,2,0,0,0,2,2,6,1,8,2,0,0,0,0,0,0,0,14576.2495696984
"2892",5,6,0,0,8,3,11,5,2,6,2,1,1,0,0,1,1,2,2979.90376562348
"2893",4,0,0,0,0,4,4,4,1,1,2,3,0,0,0,0,3,3,44741.2802951629
"2894",2,5,5,0,0,2,7,4,2,5,2,2,40,40,0,0,2,42,6408.16442126893
"2895",1,2,0,0,0,3,3,4,1,4,2,10,2,0,0,11,1,12,48357.3184291685
"2896",89,70,10,147,0,2,159,5,2,5,2,3,64,6,52,3,6,67,3734.33375879466
"2897",2,2,0,0,0,4,4,3,2,3,2,4,4,0,0,6,2,8,4136.58145763622
"2898",43,12,0,0,41,14,55,6,1,6,2,0,0,0,0,0,0,0,72935.5127293141
"2899",2,1,0,0,2,1,3,3,1,6,2,0,0,0,0,0,0,0,8932.87842519604
"2900",2,2,0,0,4,0,4,5,1,5,2,1,0,0,0,0,1,1,50460.609773186
"2901",5,15,16,0,0,4,20,3,2,4,2,4,0,0,0,0,4,4,3878.55205937165
"2902",1,0,0,0,0,1,1,4,2,4,2,1,1,0,0,0,2,2,8615.49512480105
"2903",0,3,0,0,0,3,3,3,2,4,3,3,0,0,0,0,3,3,13527.8950308406
"2904",2,0,0,0,0,2,2,5,2,8,2,0,12,10,0,0,2,12,18812.4578126086
"2905",0,0,0,0,0,0,0,2,2,4,3,0,0,0,0,0,0,0,9816.16406813649
"2906",1,0,0,0,0,1,1,5,2,4,2,11,0,0,0,9,2,11,1946.60318649901
"2907",26,29,5,20,0,30,55,5,1,7,2,28,21,35,0,12,2,49,6066.85637332598
"2908",1,7,5,0,0,3,8,2,2,3,2,0,5,5,0,0,0,5,4661.23020307171
"2909",115,0,15,0,100,0,115,6,1,7,2,0,5,0,0,5,0,5,19417.4971289048
"2910",0,0,0,0,0,0,0,4,1,7,2,1,17,16,0,0,2,18,2675.32475550502
"2911",1,0,0,0,0,1,1,2,1,2,3,1,0,0,0,0,1,1,19697.6246832096
"2912",3,11,9,0,0,5,14,3,1,6,3,4,2,0,0,1,5,6,7229.66381854717
"2913",1,0,0,0,0,1,1,5,2,3,2,0,0,0,0,0,0,0,5400.98557583817
"2914",1,1,0,0,1,1,2,3,2,4,2,0,0,0,0,0,0,0,1389.09954868951
"2915",4,0,4,0,0,0,4,2,1,3,4,12,0,0,4,4,4,12,2437.18377636681
"2916",0,2,0,0,2,0,2,6,2,2,2,0,0,0,0,0,0,0,844.092007552797
"2917",2,15,7,0,8,2,17,3,1,6,3,5,0,0,0,0,5,5,17864.8145785486
"2918",12,12,0,0,24,0,24,6,1,6,2,1,0,0,0,0,1,1,4779.22249081635
"2919",1,2,0,0,2,1,3,2,2,3,3,1,1,1,0,0,1,2,5216.97029254089
"2920",0,43,12,0,30,1,43,3,2,4,3,0,3,0,0,2,1,3,15522.7100464635
"2921",0,0,0,0,0,0,0,4,2,5,3,1,1,0,0,2,0,2,4586.73515001083
"2922",1,2,0,0,0,3,3,6,2,5,3,1,1,0,0,1,1,2,4385.78254974836
"2923",4,6,0,0,2,8,10,6,2,2,2,1,3,0,0,3,1,4,844.092007552797
"2924",5,2,0,0,3,4,7,3,2,3,2,3,10,0,0,10,3,13,1555.6101016199
"2925",1,0,0,0,0,1,1,3,2,4,2,0,0,0,0,0,0,0,1383.1130318474
"2926",15,1,0,0,1,15,16,5,2,8,3,5,12,0,0,12,5,17,23149.9536266236
"2927",1,5,0,0,5,1,6,5,2,4,2,1,0,0,0,0,1,1,1344.22680289325
"2928",1,15,12,0,2,2,16,4,2,5,2,3,2,1,0,3,1,5,3117.19808238121
"2929",2,0,0,0,0,2,2,5,2,5,2,3,0,0,0,1,2,3,1091.30071283652
"2930",0,1,0,0,0,1,1,6,2,4,2,0,1,0,0,0,1,1,945.306954963276
"2931",1,4,0,0,2,3,5,4,2,3,3,3,5,0,0,7,1,8,1846.4935559516
"2932",172,0,50,5,115,2,172,3,2,3,3,63,127,0,0,184,6,190,3736.41324661783
"2933",1,0,1,0,0,0,1,3,2,7,1,1,3,0,0,1,3,4,8719.88355483513
"2934",0,37,18,0,19,0,37,6,1,3,2,0,12,11,0,1,0,12,809.936213789201
"2935",0,0,0,0,0,0,0,5,2,3,2,0,1,0,0,1,0,1,809.936213789201
"2936",1,11,7,4,0,1,12,2,2,3,2,0,43,30,0,8,5,43,4598.32076675301
"2937",2,0,0,0,2,0,2,5,2,4,3,0,0,0,0,0,0,0,2429.3421131685
"2938",1,0,0,0,0,1,1,3,1,7,2,1,0,0,0,0,1,1,2571.98920464874
"2939",1,3,0,0,4,0,4,5,2,1,3,0,1,0,0,1,0,1,2088.97524851515
"2940",2,0,0,0,0,2,2,2,2,3,3,2,2,0,0,2,2,4,4353.74593592786
"2941",2,1,0,0,1,2,3,6,1,5,2,2,2,0,0,2,2,4,4494.22236362445
"2942",0,1,0,0,0,1,1,5,2,4,2,1,1,0,0,0,2,2,1344.22680289325
"2943",4,0,0,0,0,4,4,4,2,2,3,1,1,0,0,1,1,2,11388.4005754069
"2944",1,0,0,0,0,1,1,6,2,6,2,1,0,0,0,0,1,1,4646.94396526395
"2945",1,6,6,0,0,1,7,5,2,5,1,0,11,10,0,0,1,11,2224.21876113425
"2946",0,120,120,0,0,0,120,4,2,2,4,4,70,71,0,0,3,74,3121.51103168758
"2947",4,22,12,0,9,5,26,2,2,6,1,3,0,0,0,0,3,3,4835.80605268605
"2948",1,3,0,0,3,1,4,6,1,3,2,1,2,0,0,1,2,3,3030.16095126494
"2949",0,2,0,0,1,1,2,6,1,3,2,1,1,0,0,1,1,2,2228.96382577713
"2950",0,0,0,0,0,0,0,3,1,4,2,0,10,10,0,0,0,10,2570.07072566464
"2951",39,35,64,0,0,10,74,5,2,8,3,10,12,20,0,0,2,22,35067.2531625479
"2952",1,0,0,0,0,1,1,6,2,8,3,0,2,0,0,2,0,2,16543.8502099694
"2953",56,130,130,0,0,56,186,5,1,6,2,3,1,0,0,0,4,4,18893.8156987685
"2954",0,45,0,0,40,5,45,3,1,3,2,14,11,23,0,2,0,25,3186.67764187332
"2955",1,1,1,0,0,1,2,2,1,2,2,0,0,0,0,0,0,0,25847.2959857679
"2956",6,2,4,0,0,4,8,3,1,6,2,5,6,0,0,7,4,11,3354.33048346096
"2957",1,0,0,0,1,0,1,6,1,6,2,0,1,0,0,0,1,1,2907.55584950848
"2958",15,0,15,0,0,0,15,4,2,5,2,0,0,0,0,0,0,0,815.619257101333
"2959",1,0,0,0,0,1,1,5,1,8,2,1,3,0,0,3,1,4,2013.20535079887
"2960",16,16,30,0,0,2,32,3,1,8,2,1,12,0,0,12,1,13,7216.7657000393
"2961",2,0,0,0,0,2,2,6,2,3,2,25,20,0,0,45,0,45,809.936213789201
"2962",0,41,30,0,10,1,41,4,2,2,4,0,2,0,0,0,2,2,5156.73393582574
"2963",5,1,3,0,0,3,6,4,2,6,2,5,3,3,0,3,2,8,3198.74622121738
"2964",2,5,0,0,3,4,7,6,1,5,2,0,0,0,0,0,0,0,3411.24176558444
"2965",0,0,0,0,0,0,0,6,1,7,2,0,2,2,0,0,0,2,2296.38207255908
"2966",1,0,0,0,1,0,1,4,2,7,3,2,4,0,0,4,2,6,7543.42261672195
"2967",0,0,0,0,0,0,0,5,1,2,3,0,0,0,0,0,0,0,55117.4417543125
"2968",0,0,0,0,0,0,0,6,2,7,2,1,0,0,0,0,1,1,2061.05067827858
"2969",3,0,0,0,0,3,3,4,2,6,3,2,0,0,0,0,2,2,8485.50762813383
"2970",6,5,5,0,2,4,11,3,1,4,2,3,11,10,0,1,3,14,8294.13467626523
"2971",1,0,0,0,0,1,1,6,2,6,4,3,0,0,0,0,3,3,10408.5112397919
"2972",0,0,0,0,0,0,0,5,2,2,3,0,0,0,0,0,0,0,4559.18606565574
"2973",25,14,0,0,0,39,39,4,1,4,3,9,3,0,0,3,9,12,48340.415790912
"2974",0,0,0,0,0,0,0,4,2,3,2,0,0,0,0,0,0,0,8395.67161812398
"2975",0,1,0,0,1,0,1,6,2,3,3,1,0,0,0,1,0,1,2849.44262574763
"2976",0,0,0,0,0,0,0,3,2,4,3,3,0,0,0,0,3,3,5817.39763937198
"2977",0,0,0,0,0,0,0,6,2,5,3,8,0,0,0,0,8,8,2725.65573538179
"2978",15,15,20,0,0,10,30,5,2,4,4,52,40,49,0,40,3,92,4683.91376828936
"2979",3,8,8,0,0,3,11,2,2,6,3,2,5,0,0,0,7,7,24720.381484513
"2980",4,0,0,0,4,0,4,6,2,3,2,0,2,0,0,2,0,2,917.44111777314
"2981",6,0,3,0,0,3,6,4,2,6,2,2,4,2,0,0,4,6,1255.49144958028
"2982",1,0,0,0,1,0,1,6,1,5,3,0,0,0,0,0,0,0,11384.8882109609
"2983",2,3,0,0,3,2,5,6,1,5,2,2,4,0,0,4,2,6,6293.17810804723
"2984",3,14,17,0,0,0,17,2,1,5,2,0,2,0,0,2,0,2,1754.84520254156
"2985",0,3,0,0,3,0,3,6,2,3,2,5,4,0,0,6,3,9,1421.54643300212
"2986",0,4,0,0,0,4,4,1,2,4,3,4,10,0,10,0,4,14,63822.3546557397
"2987",9,2,0,0,5,6,11,2,2,3,3,6,5,0,0,10,1,11,57488.3507092257
"2988",2,1,0,0,3,0,3,6,2,4,3,0,0,0,0,0,0,0,33255.4906403711
"2989",5,6,0,0,6,5,11,6,2,6,3,2,2,0,0,1,3,4,6663.15347842967
"2990",0,0,0,0,0,0,0,3,1,3,2,3,2,0,0,5,0,5,12410.4284724372
"2991",5,4,0,0,5,4,9,5,2,3,2,7,0,0,0,3,4,7,1256.27481522938
"2992",0,0,0,0,0,0,0,5,2,3,2,3,52,45,0,10,0,55,5569.0673567847
"2993",12,0,0,0,12,0,12,2,1,3,3,155,3,147,0,0,11,158,45810.9652124565
"2994",0,80,30,0,50,0,80,4,1,4,2,4,10,10,0,0,4,14,20753.0167484407
"2995",3,0,0,0,3,0,3,2,1,4,2,0,4,0,0,1,3,4,7532.32708222695
"2996",5,32,35,0,2,0,37,6,1,3,3,2,2,4,0,0,0,4,16623.0668343844
"2997",16,1,5,0,10,2,17,3,2,5,3,1,0,0,0,0,1,1,11905.0275237154
"2998",0,1,0,0,0,1,1,4,2,2,3,2,1,0,0,1,2,3,3696.934333748
"2999",3,1,0,0,0,4,4,6,2,2,3,1,3,0,0,3,1,4,22179.5166261797
"3000",0,0,0,0,0,0,0,2,1,4,1,0,0,0,0,0,0,0,4549.30107824025
"3001",0,0,0,0,0,0,0,6,2,2,3,0,0,0,0,0,0,0,5158.97844202385
"3002",0,2,2,0,0,0,2,6,2,3,3,1,2,1,0,2,0,3,2840.97441088971
"3003",0,0,0,0,0,0,0,6,1,2,2,0,5,3,0,2,0,5,1633.93044542507
"3004",3,3,5,0,0,1,6,5,2,4,2,0,0,0,0,0,0,0,809.936213789201
"3005",0,977,896,0,70,11,977,2,2,1,2,8,2,2,0,0,8,10,3696.69180721368
"3006",1,3,0,0,3,1,4,5,2,4,2,1,1,0,0,1,1,2,1344.22680289325
"3007",1,0,0,0,0,1,1,1,1,3,3,0,0,0,0,0,0,0,115442.459157583
"3008",3,20,0,0,0,23,23,5,1,3,2,1,2,0,0,3,0,3,1074.12171658246
"3009",4,3,0,0,3,4,7,2,2,2,3,0,0,0,0,0,0,0,35047.5198439114
"3010",1,1,0,0,1,1,2,6,2,3,2,0,12,0,0,12,0,12,6111.52248453439
"3011",0,6,4,0,2,0,6,6,1,3,2,0,4,0,0,3,1,4,1212.482827595
"3012",0,0,0,0,0,0,0,5,2,3,3,0,2,0,0,2,0,2,5655.03870738317
"3013",0,0,0,0,0,0,0,5,1,3,3,0,0,0,0,0,0,0,58158.8003270232
"3014",0,1,0,0,0,1,1,5,2,2,5,0,1,0,0,0,1,1,1701.95374377819
"3015",3,57,58,0,0,2,60,5,1,4,2,4,3,0,0,6,1,7,809.936213789201
"3016",5,0,0,0,0,5,5,1,2,6,2,8,7,0,0,13,2,15,27954.8736377394
"3017",0,2,0,0,0,2,2,6,2,3,3,0,3,0,0,0,3,3,7959.7888166411
"3018",1,5,0,0,5,1,6,1,2,3,2,1,2,0,0,2,1,3,980.284060214716
"3019",7,1,0,0,1,7,8,4,2,3,3,0,0,0,0,0,0,0,8805.01663868901
"3020",0,0,0,0,0,0,0,5,1,2,3,0,0,0,0,0,0,0,4671.45877694907
"3021",4,4,0,0,8,0,8,5,1,2,2,0,1,0,0,1,0,1,2018.85211427955
"3022",3,5,0,0,5,3,8,5,2,6,2,4,1,0,0,0,5,5,16959.5267746324
"3023",2,80,80,0,0,2,82,5,2,2,2,0,69,65,0,0,4,69,1304.50941570974
"3024",1,6,5,0,1,1,7,3,2,4,3,0,0,0,0,0,0,0,2078.29316179665
"3025",4,2,2,0,0,4,6,1,1,4,2,5,3,1,0,3,4,8,25072.4663689705
"3026",6,3,0,0,4,5,9,4,2,8,2,3,6,0,0,9,0,9,3686.65286805293
"3027",16,12,0,0,28,0,28,3,2,3,3,2,9,0,0,11,0,11,1635.79693091739
"3028",2,1,0,0,1,2,3,3,2,2,2,4,0,0,0,0,4,4,809.936213789201
"3029",2,0,0,0,0,2,2,5,2,8,2,1,0,0,0,0,1,1,3124.58164167424
"3030",1,0,0,0,1,0,1,6,1,4,3,0,0,0,0,0,0,0,14388.347704914
"3031",5,10,11,0,4,0,15,4,2,3,2,0,9,8,0,1,0,9,1365.14748326617
"3032",1,2,0,0,0,3,3,6,2,6,3,0,1,0,0,0,1,1,52492.5441147993
"3033",0,1,0,0,0,1,1,6,2,2,2,2,1,0,0,3,0,3,1476.12662789969
"3034",0,0,0,0,0,0,0,6,2,1,3,4,0,0,0,0,4,4,3742.82587540224
"3035",3,6,4,0,2,3,9,3,2,6,2,10,6,13,0,0,3,16,1583.57036926142
"3036",0,64,0,0,0,64,64,5,2,2,3,0,0,0,0,0,0,0,26129.3256315573
"3037",3,1,0,0,0,4,4,6,1,5,2,3,4,0,0,4,3,7,839.852282534649
"3038",7,5,0,0,6,6,12,2,2,2,2,6,4,0,2,7,1,10,2545.52728661655
"3039",0,0,0,0,0,0,0,6,2,3,2,0,0,0,0,0,0,0,1425.7836977163
"3040",0,0,0,0,0,0,0,5,2,1,3,0,0,0,0,0,0,0,2095.20194706249
"3041",0,4,0,0,4,0,4,6,2,4,2,0,5,0,0,5,0,5,1265.61341844802
"3042",0,0,0,0,0,0,0,6,2,2,2,0,0,0,0,0,0,0,5959.57210986573
"3043",0,0,0,0,0,0,0,6,2,4,2,0,0,0,0,0,0,0,2525.77552259423
"3044",0,2,0,0,0,2,2,6,2,3,3,0,2,0,0,2,0,2,4204.50490169106
"3045",0,1,0,0,0,1,1,5,2,6,3,0,1,0,0,1,0,1,16765.7816319177
"3046",0,2,0,0,0,2,2,3,2,5,2,24,25,0,0,47,2,49,2045.27593046819
"3047",6,60,64,0,0,2,66,3,2,3,3,1,11,0,0,0,12,12,3736.41324661783
"3048",3,350,353,0,0,0,353,2,1,4,3,47,460,507,0,0,0,507,7691.28618322959
"3049",6,17,0,0,23,0,23,6,2,3,2,20,10,0,0,30,0,30,5085.12388155965
"3050",3,5,0,0,6,2,8,4,2,4,2,4,0,0,0,2,2,4,1586.03556140226
"3051",0,22,0,0,20,2,22,6,2,3,3,0,10,0,0,0,10,10,5607.27847920281
"3052",1,1,0,0,2,0,2,4,2,1,3,0,0,0,0,0,0,0,3960.65173512863
"3053",3,9,4,0,5,3,12,3,1,3,2,0,1,0,0,1,0,1,809.936213789201
"3054",0,2,0,0,0,2,2,6,2,2,3,0,0,0,0,0,0,0,5158.97844202385
"3055",2,0,0,0,0,2,2,6,2,6,3,2,0,0,0,0,2,2,6136.69255891378
"3056",1,0,0,0,0,1,1,5,2,1,3,0,0,0,0,0,0,0,2510.62107793144
"3057",7,28,0,27,4,4,35,1,1,1,2,18,18,30,0,0,6,36,4988.98957612779
"3058",1,0,0,0,0,1,1,6,1,4,3,1,0,0,0,0,1,1,18528.0617053015
"3059",192,0,185,0,7,0,192,3,2,4,3,0,20,0,20,0,0,20,3017.15328448418
"3060",5,14,17,0,0,2,19,3,2,2,2,16,20,33,0,0,3,36,1119.29095994322
"3061",3,0,0,0,3,0,3,3,1,1,3,6,0,0,0,2,4,6,20497.2582320299
"3062",0,41,22,0,19,0,41,3,2,4,2,15,7,22,0,0,0,22,2230.63828176706
"3063",2,0,0,0,2,0,2,6,1,6,2,1,1,0,0,0,2,2,4779.22249081635
"3064",0,38,3,35,0,0,38,1,1,1,2,2,2,0,0,4,0,4,4327.87931247498
"3065",0,7,0,0,4,3,7,6,1,6,2,1,5,0,0,5,1,6,4779.22249081635
"3066",0,19,18,0,0,1,19,2,2,2,2,15,0,12,0,3,0,15,1289.71263159508
"3067",0,30,0,0,30,0,30,6,2,3,3,3,1,0,0,1,3,4,2616.50682125367
"3068",3,11,0,0,13,1,14,6,2,4,2,1,6,6,0,1,0,7,2525.77552259423
"3069",31,26,0,0,56,1,57,5,2,8,2,2,9,0,0,10,1,11,4630.44276053959
"3070",2,3,0,0,1,4,5,6,2,2,2,1,1,0,0,1,1,2,5280.36692539586
"3071",0,0,0,0,0,0,0,5,1,1,3,0,0,0,0,0,0,0,3086.08825463809
"3072",0,0,0,0,0,0,0,6,1,4,2,2,1,0,0,1,2,3,5172.85562693867
"3073",12,20,19,0,10,3,32,3,2,5,2,12,9,9,8,1,3,21,3293.73198579866
"3074",0,0,0,0,0,0,0,5,2,8,2,2,4,0,0,3,3,6,6100.48798588587
"3075",64,0,32,0,0,32,64,5,2,4,2,4,10,0,0,10,4,14,3988.95615924279
"3076",0,7,7,0,0,0,7,4,2,3,2,0,3,0,3,0,0,3,2102.4941730349
"3077",1149,20,111,0,1015,43,1169,3,2,3,3,12,7,0,0,17,2,19,6867.5705860158
"3078",0,4,0,0,4,0,4,4,2,3,2,0,0,0,0,0,0,0,6372.55199157065
"3079",4,2,0,0,6,0,6,4,2,2,3,3,5,2,0,6,0,8,5379.32379834708
"3080",0,0,0,0,0,0,0,6,2,1,3,0,2,0,0,0,2,2,2363.79435228447
"3081",7,0,0,0,3,4,7,4,2,6,5,4,3,3,0,2,2,7,13876.3909169701
"3082",11,0,5,0,0,6,11,3,1,3,2,0,8,5,0,0,3,8,22724.3659267667
"3083",0,3,0,0,0,3,3,6,1,3,3,0,0,0,0,0,0,0,11871.2290414256
"3084",0,1,0,0,0,1,1,5,2,2,3,0,1,0,0,1,0,1,16357.6306959406
"3085",0,0,0,0,0,0,0,5,2,3,2,0,3,0,0,3,0,3,809.936213789201
"3086",3,6,0,8,0,1,9,1,1,3,3,1,1,0,0,0,2,2,25214.6101802479
"3087",14,20,0,0,21,13,34,6,2,2,3,0,0,0,0,0,0,0,29220.9366810094
"3088",7,7,0,0,14,0,14,6,2,2,2,4,3,0,0,0,7,7,809.936213789201
"3089",33,12,42,0,0,3,45,3,2,4,3,47,33,30,4,43,3,80,11609.738288601
"3090",0,0,0,0,0,0,0,1,2,3,1,10,9,0,8,10,1,19,3135.31009447317
"3091",44,39,0,0,0,83,83,5,1,2,2,40,11,21,0,0,30,51,7077.73304361715
"3092",0,1,0,0,0,1,1,6,2,3,2,8,3,0,0,11,0,11,1604.3976857467
"3093",3,0,0,0,0,3,3,4,2,5,3,4,3,0,0,0,7,7,20914.8434105052
"3094",0,1,0,0,0,1,1,2,1,3,1,0,4,0,0,0,4,4,3797.32023053592
"3095",8,8,0,0,0,16,16,4,1,6,1,3,1,0,0,1,3,4,15132.1281957612
"3096",0,0,0,0,0,0,0,5,2,4,2,0,45,0,0,45,0,45,3230.56356188171
"3097",1,1,0,0,0,2,2,2,1,1,1,4,0,0,0,2,2,4,22589.2993515187
"3098",22,54,48,24,0,4,76,2,2,7,2,53,1,50,0,1,3,54,22658.3150998654
"3099",5,0,0,0,0,5,5,2,1,2,1,4,0,0,0,0,4,4,24421.4475053145
"3100",0,3,0,0,3,0,3,6,2,4,2,1,2,0,0,3,0,3,3655.56648299206
"3101",3,4,0,0,3,4,7,3,1,7,2,3,6,8,0,0,1,9,10682.1552150019
"3102",5,0,0,0,0,5,5,5,2,4,1,5,0,0,0,0,5,5,33740.1397160233
"3103",0,6,6,0,0,0,6,5,1,6,1,0,0,0,0,0,0,0,5292.39056968004
"3104",0,1,0,0,1,0,1,5,1,4,1,9,26,20,0,13,2,35,27543.2577684897
"3105",4,0,0,0,0,4,4,4,2,5,2,6,3,0,0,5,4,9,2597.39880397711
"3106",1,1,0,0,1,1,2,2,1,2,2,4,0,0,0,3,1,4,831.000519988586
"3107",5,0,0,0,0,5,5,2,1,3,1,1,0,0,0,0,1,1,43116.6228784123
"3108",10,5,9,0,5,1,15,4,2,8,1,4,1,0,0,0,5,5,15901.1275010814
"3109",1,12,8,0,4,1,13,2,1,4,1,1,14,14,0,0,1,15,14392.7016465918
"3110",1,0,0,0,0,1,1,4,2,2,1,1,3,1,0,1,2,4,17737.6275425047
"3111",1,1,0,0,1,1,2,3,2,4,1,0,4,0,0,3,1,4,3736.80464761471
"3112",0,0,0,0,0,0,0,6,1,2,2,0,0,0,0,0,0,0,21493.765862206
